অ = First letter of the Bengali alphabet
অংশ = A section
অংশক = Part
অংশগ্রহণ = Participate
অংশগ্রহণকারী = Participant
অংশীদার = Partner
অংশীদারি = Partnership
অকণ্টক = Unconcerned
অকঠোর = Simple
অকথন = Inexplicable
অকথনীয় = Not proper to say
অকথিত = Unspoken
অকথ্য = Unutterable
অকপট = Open
অকম্পিত = Steady
অকর্ণ = Having no ear
অকর্তব্য = Improper to do
অকর্ম = Want of work
অকলুষ = Sinless
অকলুষিত = Innocent
অকল্পিত = Existing
অকল্যাণ = Evil, Harm
অকল্যাণকর = Harmful
অকস্মাত্ = Suddenly
অকাজ = Useless
অকাট্য = Conclusive
অকাতর = Not distressed or afflicted
অকাম = Having no desire or wish
অকাম্য = Unwelcome
অকারণ = Without any cause
অকার্য = A useless act
অকাল = Inopportune time
অকিঞ্চন = Little bit
অকীর্তি = A disgraceful act
অকীর্তিকর = Disgraceful
অকুল = Low family
অকুশল = Evil
অকুলীন = Not born of a high family
অকূল = Boundless
অকৃত = Not done or performed
অকৃতজ্ঞ = Ungrateful
অকৃতজ্ঞতা = Ingratitude
অকৃতদার = Unwelcome
অকৃতিত্ব = Incapacity
অকৃতী = Unworthy
অকৃত্রিম = Pure, real
অকৃত্রিমতা = Absence of artificiality
অকৃপণ = Liberal
অকৃপণতা = Liberality
অকেজো = Disabled
অক্কা = Death
অক্কাপ্রাপ্তি = Demise
অক্রূর = Not crooked or cruel
অক্রেয় = Too expensive
অক্রোধ = Absence of fear
অক্লান্ত = Untiring
অক্লেশে = Without trouble
অক্ষ = Axis
অক্ষম = Powerless
অক্ষমতা = Impotence
অক্ষর = Letter or character of alphabet
অক্ষাংশ = Latitude
অক্ষি = The eye
অক্ষিকোটর Socket of the eye
অক্ষীয় = Axial
অক্ষুণ্ণ = Unhindered
অক্ষুব্ধ = Placid
অখণ্ড = Undivided
অখাদ্য = Inedible
অখিল = Entire
অখুশি = Displeased
অখ্যাত = Obscure
অগণন = Innumerable
অগণনীয় = Not countable
অগণিত = Innumerable
অগণ্য = Uncountable
অগতি = Helpless person
অগত্যা = As an unavoidable consequence
অগন্তব্য = Inaccessible
অগভীর = Shallow
অগা Worthless
অগাধ = Unfathomable
অগুনতি = Countless
অগোচর = Unknown
অগোচরে = Invisibly
অগৌরব = Disgrace
অগ্নি = Fire
অগ্নিগর্ভ = Fiery
অগ্নিতপ্ত = Heated with fire
অগ্নিদগ্ধ = Burnt
অগ্ন্যুত্‌পাত = Volcanic eruption
অগ্র = The first of foremost
অগ্রগমন = Onward
অগ্রগামী = Leading
অগ্রজ = Elder
অগ্রজিহ্বা = Epiglottis
অগ্রণী = Prominent
অগ্রদূত = Pioneer
অগ্রহণীয় = Unacceptable
অগ্রাধিকার = Priority
অগ্রাহ্য = Rejected
অগ্রিম = Advance
অঘটন = Unusual incident
অঘটনীয় = Not likely to occur
অঘোর = Profound
অঙ্ক = Math
অঙ্কদেশ = Lap
অঙ্কন = Drawing
অঙ্কবাচক = Cardinal
অঙ্কুর = Seeding
অঙ্কুরিত = Sprouted
অঙ্কুরোদয় = Germination
অঙ্কুরোদ্গম = Sprouting
অঙ্গ = The body, physique
অঙ্গচালন = Movement of limbs
অঙ্গচ্ছেদন = Amputation of limb
অঙ্গজ = Offspring
অঙ্গন = Compound of a house
অঙ্গনা = Graceful woman
অঙ্গপ্রত্যঙ্গ = Limbs of a body
অঙ্গভঙ্গি = Physical gesture
অঙ্গমর্দন = Massage
অঙ্গহানি Loss or damage of a limb 
অঙ্গার = Coal
অঙ্গারাম্ল = Carbonic acid
অঙ্গী = Having a body or form
অঙ্গীকরণ = Making a pledge
অঙ্গীকার = Promise
অঙ্গীকৃত = Bound by promise
অঙ্গীভূত = Embodied
অঙ্গুরি = A finger ring
অচপল = Unwavering
অচল = Stationary
অচলা = Unwavering
অচলায়তন = Unprogressive institute
অচিকীর্ষু = Indolent
অচিন =  Unidentified
অচিন্তনীয় = Unthinkable
অচিন্তিত = Unexpected
অচির = Transitory
অচিরাত্‌ = Unmarked
অচূর্ণ = Intact
অচেতন = Senseless
অচেনা = Unknown
অচেষ্ট = Unenterprising
অচৈতন্য = Unconscious
অচ্যুত = Not detached
অছি = Executor
অছিলা = Medium
অজগর = Python
অজয় = Defeat 
অজর = No decaying
অজস্র = Abundant
অজাত = Bastard
অজানা = Unknown
অজান্তে = Unknowingly
অজিত = Unconquered
অজীর্ণ = Indigestion
অজুহাত = Cause
অজেয় = Unconquerable
অজৈব = Inorganic
অজ্ঞ = Ignorant
অজ্ঞাত = Unknown
অজ্ঞাতনামা = Unidentified
অজ্ঞান = Unconscious
অজ্ঞানে = Unknowingly
অজ্ঞেয় = Incomprehensible
অঝর = Incessant
অঝরে = Profousely
অঞ্জলি = Palms of hands put together
অটল = Unshaken
অটুট = Unbroken
অটোগ্রাফ্‌ = Autograph
অট্টরব = Uproar
অট্টালিকা = A big mansion
অডিকলন = A french perfume
অডিট = Audit
অডিটর = Authorized examiner
অড়র = A variety of pulse
অঢেল = Plentiful
অণিমা = Fineness
অণু = Atom
অণুবীক্ষণ = An optical instrument
অণ্ড = An egg
অণ্ডকোষ = The scrotum
অত = So much
অতঃপর = Hereafter
অতএব = Hence
অতট = A sleep surface
অতথ্য = Inaccurate
অতন্দ্র = Sleepless
অতর্ক = Useless or futile argument
অতর্কিতে = Suddenly: in a surprising manner
অতল The hollow or bowels of the earth
অতলস্পর্শ = Extremely deep
অতশত = Detailed
অতসী = Kind of yellow flower
অতি = Excessive
অতিকায় = Gigantic
অতিক্রম = Crossing
অতিক্রান্ত = Passed
অতিচালাক = Clever
অতিতপ্ত = Superheated
অতিথি = Guest
অতিথিশালা = Guest house
অতিথিসেবা = Hospitality
অতিদর্প = Extreme haughtiness
অতিপাত = Spending
অতিপ্রাকৃত = Supernatural
অতিরিক্ত = More than necessary
অতিরেক = Abundance
অতিলোভী = Overgreedines
অতিষ্ঠ = Extremely annoyed or vexed
অতীত = Passed
অতীতকাল = Past
অতীব = Very much
অতুলনীয় = Incomparable
অতুষ্ট = Not satisfied
অতুষ্টি = Dissatisfaction
অতৃপ্ত = Unsatisfied
অতৃপ্তি = Lack of satisfaction
অত্যধিক = Excessive
অত্যন্ত = Extreme
অত্যল্প = Passing away or elapsing
অত্যাচার = Oppression
অত্যাচারকারী = Oppressor
অত্যাজ্য = What cannot be disowned
অত্যাবশ্যক = Absolutely necessary
অত্যাশ্চর্য = Most astonishing
অত্যাসক্ত = Very much addicted 
অত্যাসক্তি = Strong attachment
অত্যুক্তি = Exaggerated statement
অত্যুগ্র = Extremely rough
অত্যুজ্জ্বল = Extremely bright
অত্যুত্‌কৃষ্ট = Super execellent
অত্যুত্‌পাদন = Over production
অত্র = Here
অত্রস্থ = Of this palce
অথই = Very deep
অথচ = Yet
অথবা = Or
অথর্ব = Seized with the infirmities of old age
অথৈ = Unfathomable
অদণ্ডনীয় = Unpunishable
অদত্ত =Toothless
অদমনীয় = Indominable
অদম্য = Indominable
অদরকারী = Unnecessary
অদর্শন = An absence from sight
অদলবদল = Act of changing
অদহনীয় = Not combustible
অদাহ্য = Not combustible
অদিতি = The earth
অদিন = Inauspicious day
অদূর = Not distant
অদূরদর্শিতা = Imprudence
অদূরদর্শী = Imprudent
অদূরবর্তী = Nearby
অদৃশ্য = Invisible
অদৃষ্ট = Unseen
অদৃষ্টক্রমে = By chance
অদৃষ্টপূর্ব = Not seen before
অদৃষ্টবাদ = Fatalism
অদৃষ্টবাদী = Fatalist
অদৃষ্টলিপি = The unseen writing of fate
অদেখা = Unseen
অদ্বিতীয় = Unique
অদ্বৈত = Without duality or dualism
অদ্বৈতবাদ = Monism
অদ্বৈতবাদী = Monist
অদ্ভুত = Strange
অদ্য = Now
অদ্যাপি = Still now
অদ্যাবধি = Till today
অদ্রব = Insoluble
অদ্রাব্য = Insoluble
অদ্রি = Mountain
অধঃ = Beneath
অধঃকৃত = Defeated
অধঃক্রম = Descending order
অধঃপতন = Degeneration
অধঃপতিত = Downfallen
অধঃপাত = Downfall
অধঃস্থ = Subordinate
অধম = Inferior
অধমর্ণ = Borrower
অধর = The lower lip
অধরমধু = Have a sucking or intoxicating kiss
অধরোষ্ঠ = The lips
অধর্ম = Irreligion
অধর্মপরায়ণ = Committing sins 
অধস্তন = Lying low
অধার্মিক = Impious
অধার্মিকতা =  Impiety
অধিক = More
অধিকরণ = The locative case
অধিকর্তা = Director
অধিকাংশ = Greater part
অধিকার = Ownership
অধিকারি = Owner
অধিকৃত = Conquered
অধিত্যকা = A plateau
অধিনায়ক = A leader
অধিনায়কত্ব = Leadership
অধিপ = An owner
অধিবাস = An abode
অধিবাসী = An inhabitant
অধিবৃত্ত = A parabola
অধিবৃত্তি = Extra remuneration to employees
অধিবেশন = Meeting
অধিরথ = Chariot driver
অধিরাজ = En emperor
অধিরাজ্য = A dominion
অধিরোহণ = Act of mounting
অধিষ্ঠাতা = Dwelling
অধিষ্ঠান = Existence
অধিষ্ঠিত = Occupying
অধীত = What has been read, studied
অধীন = Subjugated
অধীনতা = Subjection
অধীর = Restless
অধুনা = Nowadays
অধৈর্য = Impatience
অধোগতি = Downward motion
অধোগমন = Descent
অধোগামী = Descending
অধোদেশ = The lower portion
অধোবদন = Looking downwards
অধ্যক্ষ = Principal
অধ্যয়ন = Assiduous study or reading
অধ্যয়নরত = Studying
অধ্যাত্ম = Physical
অধ্যাপক = Teacher
অধ্যাপনা = Act of teaching
অধ্যায় = Chapter
অধ্যুষিত = Inhabited
অধ্রুব = Not stable
অনক্ষর = Unlettered
অনঙ্গ = The hindu god of love
অনচ্ছ = Not crystal
অনটন = Shortage
অনড় = Motionless
অনতিক্রমণীয় = What cannot ne overcome
অনতিক্রম্য = Impassable
অনতিদীর্ঘ = Not very long
অনতিপূর্বে = Long before
অনতিবিলম্বে = Before long
অনতীত = Not yet gone by
অনধিক = Not exceeding
অনধিকার = Absence of right
অনধিকারচর্চা = Interference
অনধিকারপ্রবেশ = Intrude
অনধীত = Not suited or persued
অনধ্যায় = Rest from study
অননুকরণীয় = Not to be limited
অননুমোদন = Absence of approval
অননুমোদিত = Unapproved
অননুশীলন = Absence of regular practice
অননুষ্ঠিত = Not performed
অনন্ত = Boundles
অনন্তকাল = Eternal
অনন্তর = Then
অনন্য = Unusual
অনন্যসাধারণ = Uncommon
অনন্যসুলভ = Unique
অনন্যোপায় = Having no means or resource other than
অনপরাধ = Innocence
অনপরাধী = Innocent
অনপেক্ষ = Impartial
অনপেক্ষিত = Unexpected
অনবকাশ = Absence or want of leisure
অনবগত = Uniformed
অনবগুণ্ঠিত = Not veiled
অনবচ্ছিন্ন = Without break
অনবচ্ছেদ = Absence of intermission
অনবদ্য = Flawless
অনবধান = Absence of attention
অনবধানতা = Inadvertently
অনবরত = Ceaseless
অনবরুদ্ধ = Not confined
অনবরোধ = Freedom from restriction
অনবসর = Absence of leisure
অনবস্থা = Lack of order
অনবহিত = Inattentive
অনভিজাত = Not aristocratic
অনভিজ্ঞ = Inexperienced
অনভিজ্ঞতা = Inexperience
অনভিপ্রায় = Unwillingness
অনভিপ্রেত = Undesirable
অনভিভূত = Undefeated
অনভিলাষ = Unwilling
অনভ্যস্ত = Unaccustomed
অনভ্যাস = Lack of practice
অনমনীয় = Inflexible
অনর্গল = Fluently
অনর্থ = Priceless
অনর্থক = Mishap
অনর্থকর = Futile
অনল = Fire
অনলস = Diligent
অনশন = Starvation
অনশনধর্মঘট = Hunger strike
অনশ্বর = Indestructible
অনশ্বরতা = Immortality
অনসূয় = Free from envy
অনস্বীকার্য = Undeniable
অনাগত = Future
অনাত্মীয় = No blood connection
অনাথ = Orphan
অনাথা = Shelterless
অনাথাশ্রম = Orphanage
অনাদর = Inattention
অনাদি = Old
অনাদেয় = Unrealizable
অনাবশ্যক = Unnecessary
অনাবাদী = Uncultivated
অনাবিষ্কৃত = Not yet discovered
অনাবৃত = Uncovered
অনাবৃষ্টি = Shortage of rainfall
অনায়ত্ত = Exertion
অনায়াস = Ease
অনায়াসলব্ধ = Easily gained
অনায়াসসাধ্য = Nor hard to accomplish
অনারারি = Honorary
অনারেব্‌ল্‌ = Honourable
অনার্দ্র = Dry
অনার্য = Uncultured
অনালোচনীয় = Not to be considered
অনাশ্রয় = Shelterless
অনাসক্ত = Indifferent
অনাসক্তি = Indifference
অনাসৃষ্টি = Bizzare
অনাস্থা = No confidence
অনাস্বাদিত = Unenjoyed
অনাহত = Unhurt
অনাহার = Fasting
অনাহারী = Fasting
অনাহূত = Uninvited
অনিকেত = Shelter
অনিচ্ছা = Unwillingness
অনিচ্ছাকৃত = Unintentional
অনিচ্ছু = Unwilling
অনিত্য = Transitory
অনিদ্রা = Sleeplessness
অনিন্দনীয় = Impeccable
অনিন্দিত = Not censured
অনিন্দিতা = Unblemished
অনিবার্য = Unpreventable
অনিমিষ = Steadfast
অনিয়ন্ত্রিত = Uncontrolled
অনিয়ম = Irregularity
অনিয়মিত = Irregular
অনিরুদ্ধ = Unchecked
অনির্ণেয় = Indeterminate
অনির্দিষ্ট = Not specified
অনির্দেশ = Uncertain state
অনির্ধারিত = Unscheduled
অনির্বচনীয় = Unspeakable
অনির্বাণ = Deprived
অনিল = Air
অনিশ্চয় = Uncertainty
অনিশ্চিত = Unsure
অনিষ্ট = Harm
অনিষ্টকর = Injurious
অনিষ্টকারী = A wrong doer
অনীক = Army
অনীকিনী = Division of the army
অনীশ্বরবাদ = Atheism
অনীশ্বরবাদী = Atheist
অনীহ = Apathetic
অনীহা = Apathy
অনুকম্পা = Compassion
অনুকরণ = Imitation
অনুকরণকারী = Imitator
অনুকার = Imitation
অনুকূল = Favourable
অনুকৃত = Imitated
অনুকৃতি = Mimicry
অনুক্ত = Not uttered
অনুক্রম = Sequence
অনুক্ষণ = Every moment
অনুগ = Follower
অনুগত = Obedient
অনুগমন = Follow
অনুগামী = Folowing
অনুগৃহীত = Benefitted
অনুগ্রহ = Kindness
অনুচর = Follower
অনুচরী = Retinue
অনুচিকীর্ষা = Desire for imitation
অনুচিত = Improper
অনুচ্চ = Low
অনুচ্চার্য = Unutterable
অনুচ্ছেদ = Paragraph
অনুজ = Younger
অনুজ্জ্বল = Dull
অনুজ্ঞা = Order
অনুজ্ঞাত = Ordered
অনুতপ্ত = Repentant
অনুতাপ = Repentance
অনুতাপী = Repenter
অনুত্তম = Excellent
অনুত্তর = Silent
অনুদান = Government grant
অনুদার = Not liberal
অনুধাবন = Pursuit
অনুনয় = Earnest request
অনুনাদ = Resonance
অনুনাদিত = Echoed
অনুনাসিক = Nasal
অনুন্নত = Backward
অনুপম = Peerless
অনুপযুক্ত = Inappropriate
অনুপযোগিতা = Incompetence
অনুপস্থিত = Absent
অনুপস্থিতি = Absence
অনুপাত = Ratio
অনুপায় = Want of means or resource
অনুপূরক = Extra
অনুপূর্ব = Serial order
অনুপ্রবেশ = Infiltration
অনুপ্রাস = Alliteration
অনুপ্রেরণা = Inspiration
অনুবন্ধী = Associated
অনুবর্তন = Act of pursuing
অনুবাদ = Translation
অনুবিধি = Act of pursuing
অনুবেদন = Sympathy
অনুভব = Perception
অনুভূতি = Feeling
অনুভূমিক = Horizontal
অনুমতি = Permission
অনুমান = Supposition
অনুমিত = Appear
অনুমোদন = Consent
অনুযায়ী = Like
অনুযোগ = Imputation of a fault
অনুরক্ত = Devoted
অনুরঞ্জন = Adulation
অনুরণন = Resonance
অনুরণিত = Resounded
অনুরাগ = Love
অনুরুদ্ধ = One who has been requested
অনুরূপ = Of the same kind
অনুরোধ = Expression
অনুলিখন = Dictation
অনুশাসন = A legal rule
অনুশীলন = Culture
অনুশীলনী = Exercise
অনুশোচন = Repentance
অনুষঙ্গ = Context
অনুসন্ধান = Search
অনুসন্ধিত্‌সা = Inquisitiveness
অনুসন্ধিত্‌সু = Eager to know
অনুসরণ = Following
অনুসৃত = Followed
অনুসৃতি = Imitating
অনুস্বর = The vowel sound
অনূঢ় = A bachelor
অনূদিত = Translated
অনূর্ধ্ব = Under
অনৃত = Not true
অনেক = Many
অনৈক্য = Absence of unity
অনৈচ্ছিক = Involuntary
অনৈসর্গিক = Supernatural
অনৌচিত্য = Impropriety
অন্ত = End
অন্তর = The heart
অন্তরা = Middle stave of a song
অন্তরাত্মা = Individual soul
অন্তরায় = Obstacle
অন্তরাল = Place out of sight
অন্তরিত = Vanished
অন্তরীক্ষ = The space above the earth
অন্তরীণ = Internee
অন্তরীপ = A cape
অন্তরীয় = Lower garment
অন্তর্গত = Included in
অন্তর্দাহ = Great affliction
অন্তর্দৃষ্টি = Intution
অন্তর্দেশ = The heart
অন্তর্ধান = Vanishing
অন্তর্নিহিত = Placed within
অন্তর্বর্তী =  in between
অন্তর্বাণিজ্য = Inland trade
অন্তর্বাস = Underwear
অন্তর্বিগ্রহ = Civil war
অন্তর্বিবাহ = Endogamy
অন্তর্বেদনা = Mental anguish
অন্তর্ভুক্ত = Included
অন্তর্ভেদী = Penetrating
অন্তর্মুখ = Spiritual
অন্তর্যামী = Knowing the mind
অন্তর্হিত = Disappeared
অন্ত্র = Bowels
অন্দর = Harem
অন্ধ = Blind
অন্ধকার = Darkness
অন্ধিসন্ধি = Cavity
অন্ধ্রপ্রদেশ = The state of india
অন্ন = Boiled rice
অন্বয় = Relation
অন্বয়ী = Connected
অন্বিত = Possessed
অন্বেষণ = Inquiry
অন্য = Some other
অন্যতম = One of a number
অন্যত্র = Elsewhere
অন্যথা = Otherwise
অন্যদিন = Other day
অন্যভাবে = Different way
অন্যমনস্ক = Absent minded
অন্যান্য = Others
অন্যায্য = Unjust
অন্যায় = Unjust action
অন্যায়ত = Unjustly
অপকর্ষ = Degeneration
অপকার = Harm
অপকৃষ্ট = Base
অপকেন্দ্র = Centrifugal
অপক = Not ripe
অপক্ষপাত = Impartiality
অপগত = Rejection
অপচয় = Waste
অপচার = Improper conduct
অপচিকীর্ষু = Malice
অপটু = Unskilled
অপঠিত = Unread
অপণ্ডিত = Illiterate
অপত্নীক = Widower
অপথ্য = Wrong diet
অপদস্থ = Insulted
অপদার্থ = Worthless
অপনয়ন = Removal
অপনীত = Removed
অপনোদিত = Wiped out
অপবাদ = Bad name
অপবিত্র = Unholy
অপব্যবহার = Misconduct
অপব্যয় = Wastage
অপভাষা = Obscene language
অপভ্রংশ = Corruption of a word
অপমান = Insult
অপমৃত্যু = Unnatural death
অপযশ = Infamy
অপয়া = Omnious
অপর = Other
অপরাজিত = Unbeaten
অপরাধ = Offence
অপরাহ্ণ = Afternoon
অপরিকল্পিত = Unplanned
অপরিগ্রহ = Refusal
অপরিচয় = Unfamiliarity
অপরিচ্ছন্ন = Unclean
অপরিণত = Immature
অপরিণামদর্শী = Lacking of foresight
অপরিত্যাজ্য = Indispensable
অপরিপক্ব = Green, Not ripe
অপরিপূর্ণ = Not full
অপরিবর্তন = Alteration
অপরিবর্তিত = Unchanged
অপরিবাহী = Non conducting
অপরিমেয় = That which can not be measured
অপরিষ্কার = Uncleanliness
অপরিসর = Narrow
অপরিসীম = Unlimited
অপরিস্ফুট = Indistinct
অপরিহার্য = Unavoidable
অপরীক্ষিত = Unexamined
অপরূপ = Incomparable
অপরোক্ষ = Not indirect
অপর্ণা = Hindu goddess Durga
অপর্যাপ্ত = Inadequate
অপলক = Winkless
অপলাপ = Denial
অপসরণ = Exit
অপসারণ = Shifting
অপহত = Perished
অপহরণ = Stealing
অপাচ্য = Indigestable
অপাঠ্য =  obscene
অপাত্র = Unworthy
অপাদান = Ablative case
অপার = Boundless
অপারগ = Not able
অপার্থিব = Unearthy
অপার্যমানে = In case of inability
অপিচ = Moreover
অপুত্রক = Without a son
অপুষ্ট = Undeveloped
অপুষ্টি = Want of nutrition
অপুষ্পক = Unflowering
অপূর্ণ = Incomplete
অপূর্ব = Unprecedented
অপেক্ষা = Reliance
অপেয় = Undrinkable
অপৌরুষ = Unmanliness
অপ্রকাশ = Not known
অপ্রকাশিত = Unrevealed
অপ্রকৃত = Not genuine
অপ্রকৃতিস্থ = Unbalanced
অপ্রচলিত = Not in vogue
অপ্রতিদ্বন্দ্বী = Unrivalled
অপ্রতিভ = Perplexed
অপ্রতিম = Unparalleled
অপ্রতিহত = Unresisted
অপ্রতুল = Insufficiency
অপ্রত্যাশিত = Unexpected
অপ্রয়োজন = Want of necessity
অপ্রশস্ত = Narrow
অপ্রসন্ন = Displeased
অপ্রস্তুত = Disconnected
অপ্রাকৃত = Unnatural
অপ্রাপ্তবয়স্ক = Minor
অপ্রাসঙ্গিক = Irrelevent
অপ্রীতিকর = Unpleasant
অপ্সরা = Celestial nymph
অফিস = Office
অফিসার = Officer
অফুরন্ত = Unending
অবক্ষয় = Waste
অবক্ষেপ = Inferiority
অবগত = Informed
অবগতি = Information
অবগাহন = Bathing immersion in a pond or river
অবগুণ্ঠন = Veil for the head
অবচেতন = Subconscious
অবজ্ঞা = Disregard
অবতরণ = Disemberk
অবতল = Curved inward
অবতার = Incarnation
অবতীর্ণ = Descend
অবদমন = Repression
অবদান = Contribution
অবধারণ = Determination
অবনত = Bent down
অবনি = The earth
অবমাননা = Insult
অবয়ব = Limb
অবরুদ্ধ = Obstructed
অবরোধ = Obstruction
অবরোহ = Decend
অবর্তমান = Inexistent
অবলা = Feeble
অবলোকন = Surveying
অবশ = Unruly
অবশিষ্ট = Remaining
অবশ্য = Surely
অবসন্ন = Fatigued
অবসর = Leisure
অবসান = Termination
অবস্থান = Residing
অবস্থিত = Located
অবহিত = Attentive
অবহেলা = Neglect
অবাক = Astonished
অবাধ = Unhindered
অবাধ্য = Disobedient
অবান্তর = Irrelevant
অবাস্তব = Fanciful
অবিকল = Exact
অবিকৃত = Unchanged
অবিদিত = Unknown
অবিদ্যমান = Not Present
অবিদ্যা = Ignorance
অবিনয় = Indecorum
অবিনশ্বর = Immortal
অবিনীত = Impolite
অবিন্যস্ত = Messy
অবিবাহিত = Unmarried
অবিভাজ্য = Indivisible
অবিরত = Ceaseless
অবিরল = Continuous
অবিরাম = Non stop
অবিশ্বাস = Lack of faith
অবিশ্রাম = Untiring
অবিসংবাদ = Undisputed
অবুঝ = Foolish
অবৈধ = Unlawful
অবোধ = Unreasonable
অবোধ্য = Incomprehensible
অব্দ = Year
অব্যক্ত = Not manifested
অব্যয় = Imperishable
অব্যর্থ = Failing
অব্যাহত = Unhindered
অভদ্র = Uncivil
অভয় = Courage
অভাগা = Luckless
অভাব = Want
অভাবনীয় = Unthinkable
অভিজ্ঞ = Specialized
অভিধান = Dictionary
অভিনন্দন = Congratulations
অভিনব = Recent
অভিপ্রায় = Desire
অভিপ্রেত = Desired
অভিব্যক্তি = Unfolding
অভিমান = Pique
অভিযুক্ত = Accused
অভিযোগ = Complaint
অভিরুচি = Wish
অভিশপ্ত = Cursed
অভিশাপ = Curse
অভিহিত = Designated
অভ্যাগত = Visitor
অভ্যাস = Habit
অভ্যুত্থান = Coup d'etal
অভ্যুদয় = Advent
অভ্র = Mica
অমত = Disapproval
অমনোযোগ = Inattention
অমর = Immortal
অমর্যাদা = Disregard
অমল = Clear
অমলিন = Unstained
অমাত্য = Courtier
অমানুষ = Brute
অমানুষিক = Brutal
অমান্য = Disobey
অমাবস্যা = The last day of the dark fortnight
অমায়িক = Plain and honest
অমার্জিত = Uncivil
অমিত = Immeasurable
অমিতাচার = Intemperate
অমিত্রাক্ষর = Rhymeless
অমিয় = Nectar
অমিল = Dissimilarity
অমিশ্র = Unmixed
অমীমাংসিত = Undecided
অমুক = A certain
অমূলক = Baseless
অমূল্য = Priceless
অমৃত = Nectar
অমোঘ = Unfailing
অম্বল = Sour taste
অম্বু = Water
অম্ল = Acidity
অম্লজান = Oxyzen
অম্লান = Unfaded
অযত্ন = Neglect
অযথা = Unnecessary
অযথার্থ = Untrue
অযথা = Unnecessary
অযোগ্য = Unworthy
অযৌক্তিক = Unreasonable
অয়ন = A path
অয়নমণ্ডল = Ecliptic
অরক্ষিত = Unprotected
অরণ্য = Wood
অরবিন্দ = The lotus
অরসজ্ঞ = Unwitty
অরাজক = Lawless
অরি = Enemy
অরুচি = Apathy
অরুণ = The sun
অরূপ = Formless
অর্ক = The sun
অর্গল = A hindrance
অর্ঘ = Price
অর্ঘ্য = Offerings at the alter of worship
অর্চনা = Worship
অর্জন = Earning
অর্থ = Money
অর্থাগম = Income
অর্থাত্‌ = In other words
অর্থান্তর = Different interpretation
অর্ধ = Half
অর্ধচন্দ্র = Crescent
অর্ধাংশ = Half share
অর্ধাঙ্গ = Half of the body
অর্পণ = Act of giving
অর্বাচীন = Posterior
অর্বুদ = Ten crores
অর্শ = Piles
অলক = Ringlet
অলকানন্দা = River in india
অলক্ষণ = Bad omen
অলক্ষিত = Unnoticed
অলক্ষ্মী = Graceless
অলক্ষ্য = Unseen
অলঙ্করণ = Decoration
অলঙ্কার = Jwellery
অলস = Lazy
অলীক = Falsehood
অলৌকিক = Superhuman
অল্প = Small in quantity-
অশঙ্ক = Fearless
অশন = Meal
অশনি = Thunder
অশরীরী = Spiritual
অশান্ত = Not calm
অশুদ্ধ = Incorrect
অশুভ = Evil
অশেষ = Endless
অশোক = Free from grief
অশোভন = Unbecoming
অশ্রাব্য = Obscene
অশ্রু = Lear
অশ্রুত = Unheard of
অশ্লীল = Obscene
অশ্লেষা = A star considered inauspicious by astrologers
অষ্ট = Eight
অষ্টাদশ = Eighteen
অসংখ্য = Innumerable
অসংগত = Unrestrained
অসংযম = Intemperance
অসংস্কৃত = Unrefined
অসঙ্কোচ = Absence of hesitation
অসতর্ক = Careless
অসতী = Unchaste
অসত্য = Untrue
অসদাচরণ = Misbehaviour
অসদ্ব্যবহার = Improper
অসদ্ভাব = Want of amity
অসন্তুষ্ট = Displeased
অসন্দিগ্ধ = Unsuspecting
অসবর্ণ = Inter-caste marriage
অসভ্য = Uncivilized
অসম = Unequal
অসমঞ্জস = Inconsistent
অসমতল = Uneven
অসমতা = Inequality
অসময় = Improper time
অসমর্থ = Unable
অসমসাহস = Uncommon courage
অসমান = Uneven
অসমাপিকা = Not making complete
অসমাপ্ত = Incomplete
অসমীচীন = Improper
অসম্পূর্ণ = Incomplete
অসম্ভব = Not possible
অসম্মত = Unwilling
অসম্মান = Dishonour
অসহ = Unbearable
অসহযোগ = Absence of cooperation
অসহায় = Helpless
অসহিষ্ণু = Impatient
অসহ্য = Unbearable
অসাধারণ = Uncommon
অসাধু = Evil
অসাধ্য - impractible
অসাবধান = Careless
অসাময়িক = Non-military
অসামাজিক = Unsociable
অসামান্য = Uncommon
অসাম্প্রদায়িক = Nun-communal
অসার = Unsubstantial
অসীম = Unbounded
অসুখ = Grief
অসুস্থ = Unwell
অস্ত = The setting of the sun or moon
অস্ত্র = Weapon
অস্ত্রাগার = Armoury
অস্থাবর = Movable
অস্থায়ী = Temporary
অস্থি = Bone
অস্থিতিস্থাপক = Inelastic
অস্থির = Unsteady
অস্পষ্ট = Indistinct
অস্ফুট = Inarticulate
অস্বচ্ছ = Opaque
অস্বস্তি = Discomfort
অস্বাভাবিক = Unnatural
অস্বাস্থ্য = Ailment
অস্বীকার = Refusal
অহমিকা = Egoism
অহিংসা = Absence of malice
অহিত = Harm
আ = Second vowel of the Bengali alphabet
আঁকা = Draw
আইন = Law
আকর = Mine
আকর্ষণ = Attraction
আকস্মিক = Sudden
আকাঙ্ক্ষা = Desire
আকার = Shape
আকাল = Scarcity
আকাশ = Sky
আক্রমণ = Invasion
আক্রান্ত = Attacked
আক্রোশ = Grudge
আক্ষরিক = Letters
আক্ষেপ = Regret
আখ = Sugarcane
আখড়া = Club
আখ্যা = Appellation
আগ = Fire
আগন্তুক = Visitor
আগমন = Arrival
আগাম = Advance
আগামী = Next
আগার = House
আগুয়ান = Forward
আগ্রহ = Eagerness
আঙুর = Grape
আঙুল = Finger
আচরণ = Conduct
আচ্ছা = Yes
আজ = Today
আট = Eight
আটক = Detained
আটকানো = Check
আঠা = Gum
আড় = Crooked
আড়ত = Warehouse
আড়ম্বর = Pomp
আড়ি = Sulky mood
আণবিক = Molecular
আতঙ্ক = Terror
আতপ = Sunshine
আতর = Perfume
আতশ = Heat
আতশবাজি = Fireworks
আতিথ্য = Hospitability
আত্ম = Own
আত্মীয় = Relative
আদত = Genuine
আদপে = Really
আদব = Etiquette
আদম = Man
আদমশুমার = Census
আদর = Caress
আদা = Ginger
আদায় = Realization
আদালত = Court
আদিম = Primitive
আদেশ = Order
আধা =half
আধিক্য = Excess
আধিপত্য = Mastery
আধ্যাত্মিক = Spiritual
আনন্দ = Delight
আনমনা = Unmindful
আনাগোনা = Coming and going
আনাড়ী = Untrained
আনার = Pomegranate
আনারকলি
আনারস = The pineapple
আনীত = Fetched
আনীল = Bluish
আনুগত্য = Allegiance
আনুমানিক = Probable
আন্তরিক = Sincere
আন্তরীক্ষ = Celestial
আন্দাজ = Guess
আন্দাজি = Baseless
আন্দোলন = Agitation
আপত্তি = Objection
আফসোস = Remorse
আবকার = Distiller
আবছায়া = Shadowy
আবদার = Demand
আবদ্ধ = Besieged
আবরণ = Clothing
আবর্ত = Whirling
আবশ্যক = Need
আবহ = Carrying
আবহমান = Passing
আবাদ = Cultivation
আবার = Again
আবাস = Residence
আবির্ভাব = Appearance
আবিল = Defiled
আবিষ্ট = Overwhelmed
আবৃত = Covered
আবৃত্তি = Recitation
আবেদন = Prayer
আভাষ = Preface
আভিজাতিক = Aristocratic
আভিধানিক = Lexographic
আম = Mango
আমড়া = The hog-plum
আমদানি = Import
আমন = Winter
আমন্ত্রণ = Invitation
আমল = Reign
আমলা = Government officer
আমাদের = Our
আমানত = Deposit
আমার = Mine
আমি = I
আমিন = Land surveyor
আমূল = The root
আমোদ = Joy
আয় = Income
আয়কর = Tax
আয়ত = Large
আয়তক্ষেত্র = Rectangle
আয়না = Mirror
আয়াস = Effort
আয়ু = Span of life
আয়ুর্বেদ = Atharvaveda
আয়েশ = Ease
আয়োজন = Arrangement
আর = And
আরক = Extract
আরজি = Application
আরণ্য = Forest
আরতি = Cessation
আরব = Arabia
আরশি = Mirror
আরাধন = Prayer
আরাম = Grove
আরূঢ় = Mounted
আরোগ্য = Cure
আর্ট = Creation or expression of beauty
আর্ত = Afflicted
আর্তনাদ = Cry
আর্থিক = Financial
আর্য = An aryan
আলখাল্লা = Longskirted tunic
আলগা = Free
আলগোছ = Untouched
আলঙ্কারিক = Rhetorical
আলতো = Soft
আলনা = Stand for clothes
আলপিন = Pin
আলম্ব = Shelter
আলয় = House
আলসে = Lazy
আলাপ = Discussion
আলিঙ্গন = Embrace
আলু = Potato
আলুলায়িত = Loose
আলেয়া = Luminous
আলো = Light
আলোক = Light
আলোচনা = Discussion
আলোড়ন = Chuming
আশঙ্কা = Doubt
আশপাশ = Surrounding
আশা = Hope
আশীর্বাদ = Bless
আশ্চর্য = Strange
আশ্বস্ত = Assured
আশ্বিন = Aswin
আশ্রম = Hermitage
আশ্রয় = Shelter
আশ্রুত = Pledged
আসঙ্গ = Association
আসন্ন = Imminent
আসর = Effect
আসল = Pure
আসা = Come
আসান = Relief
আসীন = Seated
আস্ত = Whole
আস্তরণ = Covering
আস্তানা = Haunt
আস্তাবল = Stable
আস্তিক = Theist
আস্তিকতা = Theism
আস্তিন = Sleeve
আস্তে = Slowly
আস্থা = Confidence
আস্পর্ধা = Audacity
আস্ফালন = Brag
আস্বাদ = Taste
আহত = Hurt
আহূত = Invited
আহ্নিক = Dally
ই = Third vowel of the Bengali alphabet
ইঁদুর = Rat
ইংরেজী = English
ইউনিভার্সিটি = University
ইক্ষু = Suger-cane
ইঙ্গিত = Hints
ইচ্ছা = Desire
ইজারা = Lease
ইজ্জত = Honor
ইট = Brickবে
ইতর = Vile
ইতি = End
ইতিহাস = History
ইত্যাদি = Et cetra
ইনকিলাব = Revolution
ইনসাফ = Fairness
ইন্দ্রিয় = Sense
ইন্ধন = Fuel
ইলিশ = Hilsa
ইশারা = Gesture
ইসলাম = Islam
ইস্পাত = Steel
ইহকাল = This time
ইহুদী = Jew
ঈ = Fourth vowel of the Bengali alphabet
ঈগল = Eagle
ঈদ = Eid
ঈদগাহ = Eidgah
ঈর্ষা = Jealousy
ঈর্ষান্বিত = Jealous
ঈশ্বর = God
ঈশ্বরনিষ্ঠা = Godliness
উ = Fifth vowel of the Bengali alphabet
উঁচু = High up
উইপোকা = Termites
উক্তি = Quote
উগরানো = Rise
উগ্র = Fierce
উচ্চ = High
উচ্চতা = Height
উচ্চশিক্ষিত = Highly educated
উচ্চাঙ্গ = High
উচ্চারণ = Pronunciation
উচ্চারিত
উচ্ছল = Pronounced
উচ্ছিষ্ট = Leftover
উচ্ছেদ = Eviction
উজাড় = Desolate
উজান = Upstream
উজ্জীবন =resuscitation
উট = Camel
উঠ = Get up
উড্ডীয়মান = Soaring
উড়োজাহাজ = Aircraft
উত্তর = Answer
উত্তরমালা = Answer
উত্তরায়ণ = Northern
উত্তীর্ণ = Passed
উত্থান = Rise
উত্থিত = Raised
উথলানো = Flat
উথালপাতাল = Upheaval
উদজ = Aquatic
উদজান = Hydrogen
উদয় = Rise up
উদর = Belly
উদারতা = Kindness
উদাস = Bored
উদাসী = Bored
উদ্দিষ্ট = Intended
উদ্দীপক = Stimulating
উদ্দীপ্ত = Excited
উদ্দেশ্য = Purpose
উদ্ধত = Haughty
উদ্ধার = Rescue
উদ্ধৃতি = Quote
উদ্বায়ী = Volatile
উদ্বিগ্ন = Anxious
উদ্বুদ্ধ = Motivated
উদ্বোধন = Inauguration
উদ্ভট = Strange
উদ্ভব = Origin
উদ্ভাবক = Inventor
উদ্ভাবিত = Invented
উদ্ভিদ = Plant
উদ্ভূত = Originated
উদ্যম = Enthusiasm
উদ্যান = Garden
উদ্যোক্তা = Entrepreneur
উদ্যোগ = Initiative
উদ্যোগী = Enterprising
উধাও = Disappear
উন্নত = Developed
উন্নতি = Improvement
উন্নয়ন = Development
উন্মাদ = Crazy
উন্মুক্ত = Open
উন্মেষ = Excitement
উন্মোচন = Unveiling
উন্মোচিত = Exposed
উপকথা = Fable
উপকরণ = Materials
উপকার = Benefit
উপকারী = Beneficial
উপক্রম = Initiative
উপগ্রহ = Satellite
উপজাতি = Tribe
উপজীবী = Subsistence
উপড়ানো = Pluck
উপত্যকা = Valley
উপদেশ = Advice
উপদেষ্টা = Adviser
উপদ্রব = Nuisance
উপধাতু = Metal
উপনিবেশ = Colony
উপনীত = Reached
উপন্যাস = Novel
উপপতি = Viceroy
উপপত্নী = Concubine
উপপদ = Byword
উপবাস = Fasting
উপযুক্ত = Appropriate
উপর = On
উপলক্ষ = Occasion
উপশম = Relief
উপশিরা = Vein
উপসংহার = Conclusion
উপসর্গ = Symptoms
উপসাগর = Bay
উপসেবক = Servant
উপসেবা = Service
উপস্থাপক = Presenter
উপহার = Gift
উপহাস = Ridicule
উপাখ্যান = Anecdote
উপাঙ্গ = Appendage
উপাচার্য = Vice Chancellor
উপাদান = Material
উপাদেয় = Delicious
উপাধি = Delicious
উপায় = Way
উপার্জন = Earnings
উপাসন = Worship
উপাস্য = God
উপাহার = Gift
উপেক্ষা = Ignore
উপেক্ষিত = Neglected
উপোষ = Fasting
উপোস = Fasting
উভচর = Amphibian
উভয় = Both
উর্বর = Fertile
উলঙ্গ = Naked
উল্কা = Meteor
উল্লিখিত = Mentioned
উল্লেখ = Mention
উল্লেখ্য = Note that
উষা = Morning
উষ্ণতা = Warmth
ঊ = The sixth vowel of the Bengali alphabet
ঊরু = Thigh
ঊর্দু = Urdu
ঊর্ধ = Above
ঊর্ধ্বতন = Senior
ঊর্ধ্বপাতন = Promotion
ঊর্ধ্ববাহু = Upper arm
ঊর্ধ্বশ্বাস = Upper breath
ঊষা = Dawn
ঊহ্য = Implied
ঋ = The seventh vowel of the Bengali alphabet
ঋক্ষ = Sage
ঋজু = Straightv
ঋণ = Loan
ঋণগ্রস্ত = In debt
ঋণশুদ্ধি = Debt settlement
ঋণাত্মক = Negative
ঋণী = Debtor
ঋতু = Season
ঋতুকাল = Season
ঋতুচক্র = Seasonal cycle
ঋতুপরিবর্তন = Change of season
ঋতুবদল = Change of season
ঋতুস্নান = Menstruation
ঋদ্ধ = Right
ঋভু = God
ঋষি = Sage
এ = The eighth vowel of the Bengali alphabet
এঁচড় = Scratch
এঁটেল = Brick
এই = This
এইটা = This is
এইদিক = This way
এইবার = This time
এইবেলা = At this time
এইমাত্র = Just now
এইরকম = Like this
এক = One
একক = Single
একখানা = One
একগাছা = A tree
একগুঁয়ে = Stubborn
একঘেয়েমি = Boredom
একচক্ষু = One eye
একচর = Monogamous
একচালা = Monotonous
একচিত্ত = Unanimity
একচুল = Single hair
একচেটিয়া = Monopoly
একচোট = A little
একজন = One
একজোট = Unity
একটা = A
একটানা = Continuous
একটু = A little
একতা = Unity
একতান = Ektan
একতারা = One star
একত্র = Together
একদা = Once
একদিক = One side
একদিন = One day
একদৃষ্টি = Glance
একনজরে = At a glance
একনাগাড়ে = Together
একনিষ্ঠা = Devotion
একপ্রস্থ = Single width
একবস্ত্র = Uniform
একবার = Once
একমত = Agree
একমাত্র = The only
একমুখো = One face
একমুঠো = A handful
একমুষ্টি = A handful
একযোগ = Simultaneously
একরকম = Somehow
একরঙা = Monochromatic
একরত্তি = Unity
একরাশ = A hundred
একরূপ = Alike
একরোখা = Unyielding
একলা = Alone
একলাগাড়ে = Together
একশ = One hundred
একা = Alone
একাংশ = Some of them
একাকার = Lonely
একাকী = Alone
একাক্ষর = Single letter
একাগ্র = Concentrated
একাগ্রচিত্ত = Concentration
একাত্ম = Unity
একাত্মবাদ = Solidarity
একাধার = Only
একাধিক = More than one
একান্ত = Private
একীকরণ = Integration
একীকৃত = Unified
একীভবন = Integration
একীভূত = Integrated
একোন = One
এক্কা = Ace
এক্ষণ = A moment
এক্সপ্রেস = Express
এখন = Now
এগুলি = These are
এছাড়া = Besides
এজন্য = Besides
এটর্নি = Attorney
এটা = It is
এড়ানো = Avoid
এতকাল = Long
এতখানি = Much
এতদ্রূপ = Similar
এতবার = So many times
এদিক = This way
এন্তেকাল = After
এপার = Beyond
এপাশ = Around
এপ্রিল = April
এফোঁড় = Boil
এবং = And
এবার = Now
এমত = So
এমতাবস্থায় = In such a situation
এমন = Such
এমনকি = Even
এমনি = Like that
এরকম = Like this
এরপর = After that
এরূপ = Like this
এরোপ্লেন = Aeroplane
এলেম = Elem
এসিড = Acid
এহেন = Like this
ঐ = The ninth vowel of the Bengali alphabet
ঐকতান = Unity
ঐক্য = Unity
ঐচ্ছিক = Optional
ঐতিহাসিক = Historical
ঐতিহ্য = Tradition
ঐতিহ্যবাহী = Traditional
ঐতিহ্যময় = Traditional
ঐশ্বরিক = Divine
ঐশ্বর্য = Opulence
ঐশ্বর্যবান = Opulent
ও = The tenth vowel of the Bengali alphabet
ওর = Her
ওই = That
ওইদিক = That way
ওইদিন = That day
ওইপাশ = Over there
ওইপ্রকার = Like that
ওইবার = That time
ওইভাবে = That way
ওইরকম = Like that
ওকালতী = Advocacy
ওকূল = The other
ওখড়ানো = To throw away
ওখান = There
ওজন = Weight
ওজনদার = Weighty
ওজোন = Ozone
ওঠ = Get up
ওঠা = Get up
ওড়না = Veil
ওতপ্রোত = That's right
ওদিক = Over there
ওদিন = That day
ওদের = Their
ওধার = Over there
ওপড়ানো = To teach
ওপর = On
ওপার = Beyond
ওপাশ = The other side
ওমরাহ্‌ = Umrah
ওয়াদা = The promise
ওয়ারিশ = The heir
ওরকম = Like that
ওলন্দাজ = The dutch
ওষধী = Medicine
ওষুধ = Medicine
ওষ্ঠ = Lip
ওস্তাদ = The master
ওহো = Oops
ঔ = The eleventh vowel of the Bengali alphabet
ঔরস = Auras
ঔষধ = Medicine
ঔষধালয় = Pharmacy
ঔষধি = Medicine
ক = The first consonant of the Bengali alphabet
কংগ্রেস = Congress
কই = Where
কক্ষ = Room
কক্ষচ্যুত = Orbital
কক্ষভ্রষ্ট = Lost the room
কখন = When
কঙ্কর = Pebbles
কঙ্কাল = Skeleton
কঙ্কালসার = Skeleton
কচি = Young
কচু = Raw
কচুরী = Kachuri
কচ্ছপ = The turtle
কটাক্ষর = Cursive
কটু = Bitter
কটূক্তি = Taunt
কট্টর = Tough
কঠিন = Difficult
কঠোর = Strict
কড়া = Strict
কড়াইশুঁটি = Cauldron
কণা = Particle
কণিকা = Granules
কণ্টক = Thorn
কণ্ঠ = Voice
কণ্ঠনালী = Vocal cords
কণ্ঠরোধ = Choking
কণ্ঠস্বর = Voice
কতক = How many
কতকাল = How long
কতক্ষণ = How long
কতখানি = How much
কতটা = How much
কতদিন = How long
কতদূর = How far
কতপ্রকার = How many
কতরকম = How much
কতল = Kill
কতশত = How many
কতিপয় = Some
কত্থক = Kathak
কত্থকনৃত্য = Kathak dance
কথকতা = Speaking
কথন = Speech
কথনীয় = Talkable
কথা = Talk
কথাশিল্পী = Talk artist
কথাসাহিত্য = Fiction
কথিত = Allegedly
কথোপকথন = The conversation
কথ্য = Spoken
কদম = Steps
কদর = Appreciation
কদর্য = Ugly
কদাচার = Misbehavior
কদাপি = Ever
কনট্রাকটর = Contractor
কনভোকেশন = Convocation
কনসার্ট = Concert
কনস্টেবল = Constable
কনিষ্ঠ = Youngest
কনুই = Elbow
কন্যা = Daughter
কন্যাপক্ষ = Bride's side
কপট = Hypocrite
কপটতা = Hypocrisy
কপাট = Door
কপাল = Forehead
কপি = Copy
কপোত = Parrot
কফি = Coffee
কফিন = Coffin
কবজ = Charm
কবজি = Wrist
কবর = Grave
কবল = Grip
কবলিত = Possessed
কবি = Poet
কবিতা = Poetry
কবিতাপাঠ = Poetry reading
কবুতর = Pigeon
কবুল = Accepted
কব্জা = Hinge
কমজোর = Weak
কমলা = Orange
কমা = Comma
কমিটি = Committee
কমিশন = Commission
কম্পন = Vibration
কম্পমান = Vibration
কম্পাউন্ডার = Compounder
কম্পাস = Compass
কম্পিত = Vibrated
কম্পোজিটর = Compositor
কম্বল = Blanket
কয়দিন = How many days
কয়লা = Coal
কয়েদি = Prisoner
করণীয় = To be done
করমর্দন = Handshake
করমুক্ত = Tax free
করলা = Gourd
করা = To do
করাত = Saw
করুণা = Mercy
করুণাময়ী = Merciful
করোটি = Skull
কর্ণগোচর = Overheard
কর্তব্য = Duty
কর্তব্যনিষ্ঠ = Dutiful
কর্তব্যপরায়ণ = Dutiful
কর্তা = Master
কর্তৃক = By
কর্তৃপক্ষ = Authority
কর্ম = Work
কর্মকর্তা = Officer
কর্মকাণ্ড = Activities
কর্মকার = Worker
কর্মকারক = Active
কর্মক্ষম = Functional
কর্মক্ষেত্র = Workplace
কর্মঠ = Work
কর্মত্যাগ = Retirement
কর্মপদ্ধতি = Procedure
কর্মপ্রচেষ্টা = Work effort
কর্মশালা = Workshop
কর্মসম্পাদন = Performance
কর্মস্থল = Workplace
কর্মী = Worker
কলকাতা = Calcutta
কলকারখানা = Factory
কলঙ্ক = Stigma
কলঙ্কিত = Tarnished
কলম = Pen
কলস = Pitcher
কলহ = Quarrel
কলা = Banana
কলাকুশল = Craft
কলাভবন = Art building
কলিজা = Liver
কলুষিত = Polluted
কলেজ = College
কলোনি = Colony
কল্কী = Kalki
কল্পনা = Imagination
কল্যাণ = Welfare
কষা = Bitter
কষাকষি = Bargaining
কষ্ট = Suffering
কষ্টদায়ক = Painful
কষ্টার্জিত = Hard earned
কসম = Swear
কসরত = Exercise
কসাই = Butcher
কসাইখানা = Slaughterhouse
কসুর = Fault
কাঁকড়া = Crab
কাঁচ = Glass
কাঁচকলা
কাঁচা = Raw
কাঁচামাল = Raw material
কাঁটা = Fork
কাঁথা = Kantha
কাঁদা = To cry
কাঁপা = Shaking
কাঁসা = Bronze
কাউন্সিল = Council
কাক = Crow
কাকতালীয় = Coincidence
কাকা = Uncle
কাকাতুয়া = Cockatoo
কাগজ = Paper
কাগজপত্র = Papers
কাঙ্গাল = Poor
কাচ = Glass
কাচা = Raw
কাজ  = Work
কাজকর্ম = Work
কাজল = Kajal
কাজী = Kazi
কাজুবাদাম = Cashew nuts
কাটা = Cut
কাটারী = Cleaver
কাঠ = Wood
কাঠকয়লা = Charcoal
কাঠঠোকরা = Woodpeckers
কাঠবিড়ালী = Squirrel
কাঠামো = Structure
কাঠি = Stick
কাঠিন্য = Difficulty
কাঠুরিয়া = Woodcutter
কাড়া = Cut off
কাণ্ড = Trunk
কাত = Tilted
কাতার = Line
কাদা = Mud
কান = Ear
কানাঘুষো = Whisper
কানুন = Law
কান্না = Crying
কান্নাকাটি = Crying
কাপড় = Clothes
কাপুরুষ = Coward
কাবা = Kaaba
কাবাব = Kebab
কাবু = Overcome
কাবুলী = Kabuli
কাব্য = Poetry
কামড় = Bite
কামড়ানো = Bite
কামনা = Desire
কামানো = Shave
কামার = Blacksmith
কামাসক্ত = Horny
কায়দা = Horny
কায়েম = Stay
কারণ = Because
কারাগার = Prison
কারাবাস = Imprisonment
কারুকার্য = Craftsmanship
কার্টিজ = Cartridge
কার্পেট = Carpet
কার্বন = Carbon
কার্য = Work
কার্যকর = Effective
কার্যকলাপ = Activity
কার্যক্রম = Activities
কার্যবিধি = Rules of Procedure
কার্যালয় = Office
কাল = Tomorrow
কালা = Black
কালি = Ink
কাল্পনিক = Imaginary
কাশি = Cough
কাষ্ঠ = Wood
কাহিনী = Story
কিংকর্তব্যবিমূঢ় = Confused
কিংবদন্তি = Legend
কিংবা = Or
কিতাব = Book
কিনা = Whether
কিন্তু = But
কিস্তি = Installment
কুঁচকানো = Installment
কুঁড়ি = Bud
কুকর্ম = Mischief
কুকুর = Dog
কুখ্যাত = Infamous
কুচকাওয়াজ = Parade
কুটির = Cottage
কুটুম্ব = Family
কুঠুরি = Axe
কুণ্ঠিত = Frustrated
কুমড়া = Pumpkin
কুয়া = Well
কুষ্ঠ = Leprosy
কুসংস্কার = Superstition
কুসুম = Yolk
কুস্তি = Wrestling
কূপ = Well
কৃত = Done
কৃতদাস = Servant
কৃত্রিম = Artificial
কৃপা = Grace
কৃমি = Worm
কৃমিনাশক = Anthelmintic
কৃষাণ = Farmer
কৃষি = Agriculture
কৃষ্ণ = Krishna
কেন্দ্র = Center
কেবিন = Cabin
কেরানি = Clerk
কেশ = Hair
কেহ = Someone
কোকিল = Cuckoo
কোট = Coat
কোটি = Crore
কোণ = Angle
কোথা = Where
কোদাল = Spade
কোমর = Waist
কোমল = Soft
কোর্ট = Court
কোলাহল = Noise
কোষ = Cells
কোষ্ঠকাঠিন্য = Constipation
কৌতুক = Joke
ক্যাম্পাস = Campus
ক্যালেন্ডার = Calendar
ক্রন্দন = Crying
ক্রম = Sequence
ক্রমশ = Gradually
ক্রমিক = Sequential
ক্রয় = Purchase
ক্রান্তি = Transition
ক্রিকেট = Cricket
ক্রিয়া = Action
ক্রীড়া = Sports
ক্রীতদাস = Slave
ক্রেতা = Buyer
ক্রোধ = Anger
ক্লান্ত = Tiredness
ক্লাস = Class
ক্ষণ = Moment
ক্ষত = Wound
ক্ষতচিহ্ন = Scars
ক্ষতবিক্ষত = Scarred
ক্ষতস্থান = Wound
ক্ষতি = Damage
ক্ষমতা = Power
ক্ষমা = Forgiveness
ক্ষমাশীল = Forgiving
ক্ষয় = Decay
ক্ষরিত = Scratched
ক্ষার = Alkali
ক্ষিপ্ত = Furious
ক্ষিপ্র = Quick
ক্ষুদ্র = Tiny
ক্ষুধা = Hunger
ক্ষুধার্ত = Hungry
ক্ষুব্ধ = Angry
ক্ষেত্র = Field
ক্ষেপণ = Tantrum
ক্ষোভ = Anger
খ = The second consonant of the Bengali alphabet
খঞ্জনী = Tambourine
খটমট = Tight
খড় = Straw
খড়কুটো = Straw
খড়ম = Clogs
খড়ি = Chalk
খণ্ড = Fragment
খণ্ডনযোগ্য = Refutable
খতম = Finished
খদ্দর = Customer
খনিজ = Minerals
খবর = News
খয়রাত = Charity
খরগোশ = Rabbit
খরচ = Cost
খরা = Drought
খসা = Scab
খাঁচা = Cage
খাঁজ = Groove
খাওয়া = Eat
খাট = Bed
খাটি = Pure
খাত = Sector
খাতা = Ledger
খাতির = For sake
খাদ = Ditch
খাদক = Eater
খাদ্য = Food
খাদ্যনালী = Esophagus
খানা = Eat
খানিক = Bit
খাম = Envelope
খামচি = Pinch
খামার = Farm
খামোশ = Quiet
খারাপ = Bad
খারিজ = Dismissed
খাল = Canal
খালি = Empty
খিড়কি = Window
খুঁজা = Looking for
খুঁজাখুঁজি = Look for
খুঁটি = Pole
খুঁতখুঁত = Detailed
খুচরা = Retail
খুন = Murder
খুনখারাপি = Murder
খুনী = Murderer
খুব = Very
খুশি = Happy
খুষ্কি = Dryness
খেচর = Mule
খেজুর = Dates
খেলনা = Toys
খেলা = Game
খেলোয়াড় = Player
খেসারত = Loss
খোঁচা = Poke
খোকা = Baby
খোদ = Himself
খোদা = God
খোয়া = Lost
খোলা = Open
খ্যাত = Fame
খ্যাতনামা = Fame
খ্যাতি = Fame
খ্রীষ্ট = Christ
খ্রীষ্টধর্ম = Christianity
খ্রীষ্টান = Christian
গ = The third consonant of the Bengali alphabet
গগন = Sky
গঙ্গা = Ganga
গজ = Yards
গঠন = Structure
গড় = Average
গড়ন = Build up
গড়িমসি = Grumpy
গণ = Mass
গণতন্ত্র = Democracy
গণনা = Count
গণনাকারী = Calculator
গণিত = Mathematics
গণ্ডমূর্খ = Stupid
গণ্য = Considered
গত = Past
গতকাল = Yesterday
গতমাস = Last month
গতানুগতিক = Traditional
গতি = Speed
গতিশীল = Dynamic
গদা = Mace
গদ্য = Prose
গন্তব্য = Destination
গন্ধ =  = Smell
গন্ধক = Brimstone
গবাদি = Cattle
গবাদিপশু = Cattle
গবেষণা = Research
গভর্নর = Governor
গভীরত্ব = Depth
গম = Wheat
গমন = Journey
গম্বুজ = Dome
গম্ভীর = Serious
গম্য = Attainable
গয়না = Jewelry
গরজ = Roar
গরম = Hot
গরিব = Poor
গরিলা = Gorilla
গরিষ্ঠ = Greatest
গরীব = Poor
গরু = Cow
গর্জন = Roar
গর্ত = Hole
গর্দভ = Ass
গর্ব = Pride
গর্বিত = Proud of
গর্ভ = Womb
গর্ভচ্যুত = Miscarriage
গর্ভধারণ = Pregnancy
গর্ভপাত = Abortion
গলা = Throat
গলানো = Melt
গলি = Street
গলুই = Gluttony
গহনা = Jewelry
গাঁজন = Fermentation
গাঁজা = Marijuana
গাঁজাখোর = Marijuana addict
গাঁদাফুল = Marigold
গাজর = Carrot
গাড়ি = Car
গাঢ় = Dark
গাথা = Story
গাধা = Donkey
গান = Song
গাফিলতি = Carelessness
গাভী = Cow
গামছা = Towel
গাম্ভীর্য = Seriousness
গায়ক = Singer
গায়িকা = Singer
গায়েব = Disappear
গার্জিয়ান = Guardian
গার্ড = Guard
গার্হস্থ্য = Domestic
গাল = Cheek
গালি = Abuse
গালিগালাজ = Abuse
গালিচা = Carpet
গিঁট = Knot
গিন্নী = Wife
গির্জা = Church
গিলা = Swallow
গীতি = Song
গুঁড়া = Powder
গুচ্ছ = Bunch
গুজব = Rumor
গুঞ্জন = Buzz
গুণ = Quality
গুণকীর্তন = Meritocracy
গুণগত = Qualitative
গুণফল = Product
গুণিতক = Multiplier
গুন = Count
গুপ্তচর = Spy
গুপ্তধন = Treasure
গুম = Missing
গুমট = Goofy
গুরুজন = Old man
গুরুতর = Serious
গুরুত্ব = Importance
গুলি = Shot
গুল্ম = Bush
গুহা = Cave
গৃহ = Home
গৃহকর্ম = Housework
গৃহত্যাগ = Leaving home
গৃহপালিত = Domesticated
গৃহস্থ = Domestic
গৃহস্থালি = Household
গৃহহীন = Homeless
গেট = Gate
গোঁড়া = Orthodox
গোঁফ = Mustache
গোচারণ = Grazing
গোচারণক্ষেত্র = Pasture
গোছা = Bunch
গোটা = Whole
গোত্র = Tribe
গোধূলি = Twilight
গোবর = Dung
গোমাংস = Beef
গোয়েন্দা = Detective
গোরস্থান = Cemetery
গোলক = Sphere
গোলযোগ = Disturbance
গোলাকার = Round
গোলাপ = Rose
গোলাম = Slave
গোলোক = Sphere
গোষ্ঠী = Group
গোসল = Shower
গোসলখানা = Bathroom
গোস্ত = Meat
গৌণ = Secondary
গৌতম = Gautama
গৌর = Respect
গৌরব = Glory
গ্যাঁজানো = Screw up
গ্যাস = Gas
গ্যাসীয় = Gaseous
গ্রন্থ = Book
গ্রন্থাগার = Library
গ্রহ = Planet
গ্রহণ = Accept
গ্রহণীয় = Acceptable
গ্রহাণু = Asteroid
গ্রহীতা = Recipient
গ্রাম = Village
গ্রামবাসী = Villagers
গ্রামীণ = Rural
গ্রামোফোন = Gramophone
গ্রাম্য = Rural
গ্রাস = Consume
গ্রাহক = Customer
গ্রীক = Greek
গ্রীবা = Neck
গ্রীষ্ম = Summer
গ্রীষ্মকাল = Summer time
গ্রেফতার = Arrested
গ্লানি = Sadness
গ্লাস = Glass
ঘ = The fourth consonant of the Bengali alphabet
ঘটনা = Event
ঘটনাক্রমে = Incidentally
ঘটনাচক্র = Cycle of events
ঘটনীয় = Likely
ঘটমান = Happening
ঘটা = Happened
ঘণ্টা = Bell
ঘন = Thick
ঘনক্ষেত্র = Cube
ঘনঘটা = Frequently
ঘনত্ব = Density
ঘনক = Cube
ঘনায়মান = Congested
ঘনিষ্ঠ = Close
ঘর = House
ঘরসংসার = Household
ঘর্ম = Sweat
ঘর্মাক্ত = Sweaty
ঘর্ষণ = Friction
ঘষা = Rub
ঘাঁটি = Base
ঘাট = Wharf
ঘাত = Hit
ঘাতক = Killer
ঘাবড়ানো = Be nervous
ঘাম = Sweat
ঘায়েল = Hit
ঘাস = Grass
ঘি = Ghee
ঘিরা = Surround
ঘুঘু = Dove
ঘুম = Sleep
ঘুমকাতুরে = Sleepy
ঘুমন্ত = Sleepy
ঘুষ = Bribe
ঘুষি = Punch
ঘূর্ণন = Rotation
ঘূর্ণমান = Rotary
ঘূর্ণায়মান = Rotating
ঘূর্ণি = Vortex
ঘূর্ণিঝড় = Cyclone
ঘূর্ণিবায়ু = Whirlwind
ঘৃণা = Hatred
ঘৃণ্য = Disgusting
ঘৃতকুমারী = Aloe Vera
ঘেঁষা = Close
ঘেরা = Surrounded by
ঘোরা = Rotate
ঘোরাঘুরি = Walk around
ঘ্রাণ = Scent
ঙ = The fifth consonant of the Bengali alphabet
চ = The sixth consonant of the Bengali alphabet
চওড়া = Wide
চক = Chalk
চকিত = Stunned
চক্কর = Circle
চক্র = Cycle
চক্রবৃদ্ধি = Compounding
চক্রাকার = Circular
চক্রান্ত = Plot
চক্ষু = Eye
চক্ষুগোচর = Visible
চক্ষুদান = Eye donation
চক্ষুশূল = Eyesore
চটকদার = Flashy
চড় = Slap
চড়া = Ride
চড়ুই = Sparrow
চড়ুইভাতি = Picnic
চতুর = Clever
চতুরতা = Cleverness
চতুর্থ = Fourth
চতুষ্কোণ = Square
চতুষ্পদী = Quadruped
চত্বর = Square
চন্দন = Sandalwood
চন্দ্র = Moon
চন্দ্রগ্রহণ = Lunar eclipse
চন্দ্রিমা = Moon
চপ = Chop
চপল = Agile
চপেটাঘাত = Slap
চপ্পল = Slippers
চমক = Surprise
চরণ = Feet
চরণামৃত = Nectar
চরম = Extreme
চরা = Graze
চরানো = Grazing
চরিত্র = Character
চরিত্রহীন = Characterless
চর্চা = Practice
চর্বণ = Chewing
চর্বি = Fat
চর্ম = Skin
চর্মশিল্প = Leather craft
চলচ্চিত্র = Movie
চলন = Movement
চলনসই = Moveable
চলন্ত = Moving
চষা = Cultivation
চা = Tea
চাঁদ = Moon
চাঁদনি = Moonlight
চাঁদা = Subscription
চাই = Want
চাউল = Rice
চাওয়া = Want
চাকচিক্য = Glitter
চাকতি = Disk
চাকর = Servant
চাকরানী = Maid
চাকু = Knife
চাকুরি = Job 
চাকুরিজীবী = Employee
চাক্ষুষ = Visual
চাচা = Uncle
চাচী = Aunt
চাটনি = Chutney
চাটা = Lick
চাটুকার = Flattering
চাতুর্য = Ingenuity
চানাচুর = Chanachur
চাপ = Stress
চাপড় = Slapped
চাপা = Pressed
চাবি = Key
চাবিকাঠি = Key
চাবুক = Whip
চামচ = Spoon
চামড়া = Skin
চার = Four
চারণভূমি = Pasture land
চারদিক = All around
চারদিন = Four days
চারপাশ = All around
চারাপোনা = Seedlings
চারুকলা = Fine arts
চার্চ = Church
চার্জ = Charge
চার্জশীট = Charge sheet
চাল = Rice
চালনী = Sieve
চালবাজ = Trickster
চালাক = Clever
চাষ = Cultivation
চাষবাস = Farming
চাষী = Farmer
চাহনি = Look
চাহিদা = Demand
চিংড়ি = Shrimp
চিকন = Thin
চিটচিটে = Sticky
চিঠি = Letter
চিড়িয়াখানা = Zoo
চিতা = Cheetah
চিতাবাঘ = Leopard
চিত্ত = Mind
চিত্র = Image
চিত্রপট = Picture
চিত্রফলক = Plaque
চিত্রশিল্পী = Painter
চিনি = Sugar
চিন্তা = Thought
চিমটি = Pinch
চিমনি = Chimney
চিরকাল = Forever
চিরকালীন = Forever
চিরকুট = Note
চিরজীবন = Eternal life
চিরদিন = Forever
চিরন্তন = Eternal
চিরসত্য = Eternal truth
চিরা = Incision
চিহ্ন = Mark
চীন = China
চীনাবাদাম = Groundnut
চুক্তি = Contract
চুক্তিনামা = Contract
চুক্তিভঙ্গ = Breach of contract
চুটকি = Pinch
চুড়ি = Bangles
চুণাপাথর = Limestone
চুন = Lime
চুনা = Lime
চুপ = Shut up
চুরমার = Crush
চুরিচামারি = Stealing
চুরুট = Cigar
চুল = Hair
চুলকানি = Itching
চুলা = Stove
চূড়া = Peak
চূড়ান্ত = Final
চূর্ণ = Crushed
চেঁচানো = Shout out
চেইন = Chain
চেতনা = Consciousness
চেনা = Known
চেয়ার = Chair
চেয়ারম্যান = Chairman
চেষ্টা = Try
চেষ্টাশীল = Effortful
চেষ্টাসাধ্য = Possible
চেহারা = Appearance
চৈতন্য = Consciousness
চোখ = Eyes
চোট = Injury
চোর = Thief
চোষক = Sucker
চোষা = Sucking
চৌধুরী = Chowdhury
চৌম্বক = Magnetic
চৌরাস্তা = Crossroads
ছ = The seventh consonant of the Bengali alphabet
ছক = Table
ছক্কা = Six
ছটফট = Jitters
ছটাক = Crack
ছড়া = Rhyme
ছড়ি = Stick
ছত্র = Umbrella
ছত্রাক = Fungus
ছদ্ম = Fake
ছদ্মবেশ = Disguise
ছন্দ = Rhythm
ছন্ন  = Picture
ছবি = Picture
ছল = Trickery
ছলচাতুরী = Trickery
ছলনা = Deception
ছলাকলা = Trickery
ছাঁচ = Mold
ছাঁটাই = Lay off
ছাই = Ash
ছাগল = Goat
ছাগী = Goat
ছাড় = Discount
ছাড়া = Except
ছাতা = Umbrella
ছাতি = Chest
ছাত্র = Student
ছাত্রাবাস = Dormitory
ছাত্রী = Student
ছানা = Chick
ছানি = Cataract
ছাপ = Impression
ছাপা = Printed
ছাপাখানা = Printing press
ছায়া = Shadow
ছায়াপথ = Galaxy
ছারপোকা = Cockroach
ছি = Shit
ছিচকা = Sneeze
ছিটা = Sprinkled
ছিটাফোঁটা = Splash
ছিদ্র = Hole
ছিদ্রযুক্ত = Porous
ছিদ্রিত = Pierced
ছিনা = Snatch
ছিন্ন = Torn apart
ছিন্নভিন্ন = Shattered
ছিল = Was
ছিলাম = Was
ছুঁচ = Needle
ছুটি = Holiday
ছুটোছুটি = Run around
ছুড়া = Throw
ছুতা = Carpenter
ছুরি = Knife
ছুরিকাঘাত = Stabbing
ছেঁচা = Scratch
ছেদ = Intersection
ছেদক = Incisor
ছেদন = Incision
ছেদ্য = Intersection
ছেলে = Boy
ছোঁড়া = Throw
ছোঁড়াছুঁড়ি = Throw away
ছোঁয়া = Touch
ছোঁয়াচে = Contagious
ছোকরা = Boys
ছোট = Small
ছোটখাটো = Minor
ছোটলোক = Little guy
ছোড়া = Thrown
ছোড়াছুঁড়ি = Throw away
ছোপ = Paint
জ = The eighth consonant of the Bengali alphabet
জগাখিচুড়ি = Mess
জঘন্য = Abominable
জঙ্গল = Forest
জঙ্গী = Militant
জজ = Judge
জট = Entangled
জটলা = Tangle
জড় = Inert
জড়তা = Inertia
জড়পদার্থ = Inert matter
জড়ায় = Tangle
জড়ো = Gather
জনক  =father
জনগণ = People
জনতা = Crowd
জনন = Generation
জননক্ষমতা = Capacity
জননী = Mother
জনপদ = Township
জনপূর্ণ = Full of people
জনপ্রিয় = Popular
জনবসতি = Population
জনবহুল = Populous
জনমত = Public opinion
জনমানব = People
জনশূন্য = Desolate
জনসংখ্যা = Population
জনসংযোগ = Public relations
জনসমক্ষে = In public
জনসমুদ্র = Sea ​​of ​​people
জনসাধারণ = Public
জনসেবা = Public service
জনস্রোত = Crowd
জনহীন = Uninhabited
জনাকীর্ণ = Crowded
জনাব = Man
জনৈক = Someone
জন্তু = Animal
জন্তুজানোয়ার = Animal
জন্ম = Birth
জন্মকাল = Date of birth
জন্মকালীন = At birth
জন্মগত = Congenital
জন্মগ্রহণ = Born
জন্মতিথি = Date of birth
জন্মদাতা = Birth giver
জন্মদান = Giving birth
জন্মভূমি = Homeland
জন্মলাভ = Birth
জন্মসূত্র = Origin
জন্মানো = To be born
জন্মান্তর = Transmigration
জন্মান্ধ = Born blind 
জন্য = For
জবা = Coercion
জবাই = 
জবানবন্দী = Confession
জবাব = Testimony
জবাবদিহি = Answer
জব্দ = Accountability
জমকানো = Seizure
জমকালো = Dazzling
জমজম = Gorgeous
জমজমাট = Crowded
জমা = Deposit
জমাখরচ = Deposit charges
জয় = Victory
জয়ধ্বনি = Victory sound
জয়ন্তী = Jubilee
জয়ী = Winning
জরা = Rusty
জরাজীর্ণ = Dilapidated
জরায়ু = Uterus
জরুরী = Urgent
জর্জরিত = Plagued
জল = Water
জলকন্যা = Mermaid
জলকপাট = Water closet
জলচর = Aquatic
জলছবি = Water picture
জলজন্তু = Water animal
জলজ্যান্ত = Aquatic life
জলতরঙ্গ = Water wave
জলদস্যু = Pirate
জলদি = Soon
জলনিষ্কাশন = Drainage
জলপাই = Olive
জলপান = Drinking water
জলযাত্রা = Water journey
জলাতঙ্ক = Rabies
জলাধার = Reservoir
জলাশয় = Reservoir
জলোচ্ছ্বাস = Tide
জহুরী = Jahuri
জাগা = Wake up
জাত = Caste
জাতি = Race
জাতিভেদ = Caste discrimination
জাতীয় = National
জাদু = Magic
জাদুকরী = Witch
জাদুঘর = Museum
জাদুবিদ্যা = Witchcraft
জানোয়ার = Beast
জান্নাত = Heaven
জাম = Berry
জামা = Clothes
জায়গা = Place
জাল = Fake
জাহাজ = Ship
জাহান্নাম = Hell
জিজ্ঞাসা = Ask
জিন = Gene
জিনিষ = Things
জিনিষপত্রর = Goods
জিন্দা = Alive
জিভ = Tongue
জিরা = Cumin
জিহ্বা = Tongue
জীব = Organism
জীবজন্তু = Animal
জীবন = Life
জীবনী = Biography
জীবন্ত = Alive
জীববিজ্ঞান = Biology
জীবহত্যা = Homicide
জীবাণু = Germs
জীবাশ্ম = Fossil
জীবিকা = Livelihood
জীবিত = Alive
জীর্ণ = Worn out
জুঁই = Jasmine
জুড়ি = Pair
জুতা = Shoes
জুন June
জুয়া = Gambling
জুয়ারী = Gambler
জুরি = Jury
জুলুম = Oppression
জেদ = Persistence
জেদী = Stubborn
জেনারেল = General
জেব্রা = Zebra
জেরা = Cross-examination
জেল = Jail
জেলা = District
জেলে = Fisherman
জৈব = Organic
জৈবযৌগ = Organic compound
জৈবরসায়ন = Biochemistry
জোঁক = Leech
জোগাড় = Collection
জোগান = Provide
জোট = Alliance
জোড় = Even
জোড়হাত = Hand in hand
জোড়া = Pair
জোড়াতালি = Applause
জোয়ার = Tide
জোয়াল = Yoke
জোর = Emphasis
জোরদার = Strong
জোরালো = Strong
জ্ঞাত = Known
জ্ঞান = Knowledge
জ্ঞানদান = Enlightenment
জ্ঞানপিপাসা = Thirst for knowledge
জ্ঞানপূর্ণ = Enlightened
জ্ঞানশূন্য = Clueless
জ্ঞাপন = Notification
জ্বর = Fever
জ্বলজ্বল = Shining
জ্বলন = Combustion
জ্বলন্ত = Fiery
জ্বলা = Burning
জ্যাকেট = Jacket
জ্যাঠা = Uncle
জ্যান্ত = Alive
জ্যামিতি = Geometry
জ্যেষ্ঠ = Senior
জ্যোতিষ = Astrology
জ্যোতিষী = Astrologer
ঝ = The ninth consonant of the Bengali alphabet
ঝক্‌ঝক্‌ = Sparkling
ঝগড়া = Quarrel
ঝটকা = Shock
ঝড় = Storm
ঝরনা = Shower
ঝরা = Drop off
ঝলমল = Shiny
ঝলসানো = Burning
ঝাঁকা = Shake
ঝাঁঝর = Grate
ঝাঁটা = Sweep
ঝাঁপ = Jump
ঝাউগাছ = Shrubbery
ঝাড় = Bush
ঝাড়া = Scrub
ঝাড়ি = Bush
ঝাড়িও = Brush up
ঝাড়ু = Broom
ঝাড়ুদার = Sweeper
ঝাপটা = Rush
ঝাপসা = Blurred
ঝাল = Spicy
ঝিকিমিকি = Twinkling
ঝিনুক = Oysters
ঝিম = Relax
ঝিমা = Relax
ঝুপড়ি = Hut
ঝুপড়ী = Hut
ঝুলা = Hung
ঝোঁক = Tend to
ঝোপ = Bush
ঞ = The tenth consonant of the Bengali alphabet
ট = The eleventh consonant of the Bengali alphabet
টং = Tong
টক = Sour
টনিক = Tonic
টপ = Top
টব = Tub
টম্যাটো = Tomato
টর্চ = Torch
টলমল = Wobbly
টলা = Avoid
টহল = Patrol
টহলদার = Patrolman
টহলদারি = Patrolling
টাইট = Tight
টাইপ = Type
টাইপরাইটার = Typewriter
টাইপিস্ট = Typist
টাইম = Time
টাউন = Town
টাক = Bald
টাকা = Money
টাকাওয়ালা = Rich
টাকাপয়সা = Money
টাঙানো = To hang
টাঙ্গাইল = Tangail
টাটকা = Fresh
টাটা = Bye
টানটান = Tight
টানব = Pull
টানা = Tight
টিউটর = Tutor
টিউবওয়েল = Tubewell
টিউশনি = Tuition
টিক = Tick
টিকা = Vaccine
টিকি = Survive
টিকিট = Ticket
টিন = Tin
টিপ = Tip
টিপা = Pressed
টিফিন = Tiffin
টিয়াপাখি = Parrot
টীকা = Vaccine
টুঁ-শব্দ = Sound
টুকটাক = Bit by bit
টুকরো = Pieces
টুকিটাকি = Bit by bit
টুপি = Cap
টেকসই = Durable
টেক্কা = Ace
টেবিল = Table
টের = Felt
টেলিগ্রাফ = Telegraph
টেলিগ্রাম = Telegram
টেলিফোন = Telephone
টেস্ট = Test
টোকা = Tap
টোপ = Bait
টোল = Toll
ট্যাক্স = Tax
ট্যাক্সি = Taxi
ট্যারা = Tara
ট্রাঙ্ক = Trunk
ট্রাম = Tram
ট্রে = Tray
ট্রেন = Train
ঠ = The twelfth consonant of the Bengali alphabet
ঠক = Cheat
ঠকা = Knock
ঠকানো = Cheat
ঠন্‌ঠন = Knocking
ঠাঁই = Place
ঠাকুর = Tagore
ঠাকুরদা = Grandpa
ঠাট্টা = Joke
ঠাট্টাতামাশা = Jokes
ঠাণ্ডা = Cold
ঠায় = Stay
ঠাস = Stuffy
ঠাসা = Stuffy
ঠিক = Right
ঠিকা = Contract
ঠিকাদার = Contractor
ঠিকানা = Address
ঠুনকো = Knock on
ঠেকা = Prevent
ঠেলা = Push
ঠেলাগাড়ি = Wheelbarrow
ঠেসা = Bump
ঠোঁট = Lips
ঠোঁটকাটা = Biting lips
ঠ্যাং = Bang
ড = The thirteenth consonant of the Bengali alphabet
ডগা = Tip
ডজন = Dozen
ডর = Fear
ডাঁসা = Ripe
ডাইন = Dine
ডাইনী = Witch
ডাক = Mail
ডাকখানা = Post office
ডাকগাড়ি = Mail car
ডাকঘর = Post office
ডাকনাম = Nickname
ডাকপিওন = Postman
ডাকপিয়ন = Postman
ডাকবাংলো = Bungalow
ডাকবাক্স = Mailbox
ডাকবিভাগ = Postal department
ডাকা = Call
ডাকাত = Robber
ডাকাতি = Robbery
ডাকি = Call
ডাকিনী = Dakini
ডাকিনীবিদ্যা = Dakinism
ডাক্তার = Doctor
ডাক্তারখানা = Doctor's office
ডাঙ্গা = Riot
ডাণ্ডা = Stick
ডান = Right 
ডানা = Wing
ডানাকাটা = Winged
ডাম্বেল = Dumbbell
ডায়েরী = Diary
ডাল = Lentil
ডালপালা = Branch
ডালিম = Pomegranate
ডিগ্রী = Degree 
ডিঙি = Canoe
ডিজাইন = Design
ডিনার = Dinner
ডিপুটি = Deputy
ডিপো = Depot
ডিম = Egg
ডিম্ব = Egg
ডিম্বকোষ = Ovum
ডিম্বাণু = Egg
ডিম্বাশয় = Ovary
ডিশ = Dish
ডিসেম্বর = December
ডুব = Dive
ডুবসাঁতার = Diver
ডুবা = Drowned
ডুবুডুবু = Drowned
ডুবুরী = Diver
ডুবো = Drown
ডুবোজাহাজ = Submarine
ডুমুর = Fig
ডুমুরফুল = Figs
ডেঙ্গু = Dengue
ডোজ = Dose
ডোরাকাটা = Striped
ড্রয়ার = Drawer
ড্রাম = Drum
ড্রেন = Drain
ঢ = The fourteenth consonant of the Bengali alphabet
ঢাক = Cover up
ঢাকনা = Lid
ঢাল = Shield
ঢালা = Pour
ঢালাই = Welding
ঢালু = Slope
ঢিপি = Mound
ঢিবি = Hill
ঢিলা = Loose
ঢিলামি = Laziness
ঢুলি = Drum
ঢুলী = Drum
ঢেঁকি = Cover up
ঢেউ = Wave
ঢের = A lot
ঢোকা = Enter
ত = The sixteenth consonant of the Bengali alphabet
তকদির = Fate
তকমা = Title
তক্ত = Hard
তক্তা = Plank
তক্ষুণি = Instantly
তখন = Then
তখনকার = At that time
তখনি = Then
তট = Shore
তটস্থ = Side by side
তড়পানো = Fast
তত = As much
ততক্ষণ = Until then
ততটুকু = That much
ততদিন = Until then
ততবার = So many times
ততরকম = Like that
ততোধিক = More
তত্ত্ব = Theory
তত্ত্বীয় = Theoretical
তত্র = So
তথা = As well as
তথাকথিত = So called
তথাপি = Nevertheless
তথ্যবাহী = Informative
তথ্যমূলক = Informative
তথ্যসংগ্রহ = Data collection
তথ্যানুসন্ধান = Search for information
তদনুযায়ী = Accordingly
তদনুরূপ = Accordingly
তদন্ত = Investigation
তদন্তকারী = Investigator
তদবধি = Until then
তদবির = Advocacy
তদারক = Supervisor
তদারকি = Supervision
তপস্যা = Penance
তপ্ত = Hot
তবলাবাদক = Drummer
তবু = However 
তরকারি = Curry
তরঙ্গ = Wave
তরঙ্গমালা = Waves
তরঙ্গায়িত = Wavy
তরফা = Side
তরবারি = Sword
তরমুজ = Watermelon
তরল = Liquid
তরলমতি = Liquid
তরলীকৃত = Liquefied
তরু = Tide
তরুছায়া = Shadow
তরুণ = Young
তরুণত্ব = Youth
তরুণাস্থি = Cartilage
তরোয়াল = Sword
তর্ক = Argument
তর্কবিতর্ক = Argument
তর্কবিদ্যা = Logic
তর্কাতর্কি = Argument
তর্কী = Argument 
তর্জনী = Index finger
তল = Floor
তলদেশ = Bottom
তলপেট = Lower abdomen
তলপ্রহার = Beating down
তলব = Summon
তলা = Floor
তলানি = Bottom
তল্লাশ = Bully
তস্কর = Smuggler
তহবিল = Funds
তাঁতঘর = Weaving mill
তাঁতী = Weaver
তাঁবু = Tent
তাই = So
তাও = That too
তাক = Shelf
তাগিদ = Urge
তাচ্ছিল্য = Indolence
তাছাড়া = Moreover
তাজ = Crown
তাজমহল = The Taj Mahal
তাজা = Fresh
তাড়কা = Fast
তাড়কারাক্ষসী = Fastidious
তাড়া = Rush
তাড়াতাড়ি = Quickly
তাড়াহুড়ো = Hurry up
তাণ্ডব = Riot
তাণ্ডবনৃত্য = Dance
তাণ্ডবলীলা = Violence
তাত্ত্বিক = Theorical
তাপ = Heat 
তাপপ্রয়োগ = Heat application
তাপমাত্রা = Temperature
তাপহরণ = Heat loss
তাবিজ = Amulet
তামা = Copper
তামাক = Tobacco
তামাশা = Joke
তামিল = Tamil
তাম্র = Copper
তার = His
তারকা = Star
তারকাখচিত = Starry
তারতম্য = Variation
তারপর = Then
তারা = They are 
তারিফ = Appreciation
তাল = Rhythm
তালগাছ = Palm tree
তালপাতা = Palm leaves
তালা = Lock
তালাক = Divorce
তালাশ = Look for
তালি = Applause
তালিকা = List
তালু = Palate
তাস = Cards
তাহলে = Then
তিক্ত = Bitter
তিক্তরস = Bitter gourd
তিক্তস্বাদ = Bitter taste
তিন = Three
তিনজন = Three people
তিনতালা = Three doors
তিনদিন = Three days
তিনবার = Three times
তিনি = He
তিব্বত = Tibet
তিমি = Whale
তিমিমাছ = Whale
তিমির = Whale
তিয়াস
তিরস্কার = Reproach
তিরস্কৃত = Condemned
তির্যক = Diagonal
তিল = Mole
তীক্ষ্ণ = Sharp
তীব্র = Intense
তীরন্দাজ = Archer
তীর্থ = Pilgrimage
তীর্থক্ষেত্র = Pilgrimage
তীর্থভূমি = Pilgrimage
তুঁষ = Bran
তুচ্ছ = Trivial
তুচ্ছতাচ্ছিল্য = Indifference
তুফান = Storm
তুমি = You
তুরঙ্গ = Tunnel
তুরস্ক = Turkey
তুরুপ = Trump
তুর্কি = Turkish
তুলনা = Comparison
তুলনীয় = Comparable
তুলসী = Basil
তুলা = Cotton
তুল্য = Comparable
তুল্যরূপ = Comparable
তুষার = Snow
তুষারপাত = Snowfall
তুষ্ট = Satisfied
তূলা = Cotton
তৃণ = Grass
তৃণভোজী = Herbivore
তৃতীয় = Third
তৃতীয়া = Third
তৃপ্ত = Satisfied
তৃপ্তি = Satisfaction
তৃষ্ণা = Thirst
তৃষ্ণার্ত = Thirsty
তেঁতুল = Tamarind
তেজ = Brightness
তেজপাতা = Bay leaf
তেজস্ক্রিয় = Radioactive
তেজস্ক্রিয়তা = Radioactivity
তেজী = Fast
তেত্রিশ = Thirty three
তেপান্তর = Transition
তেমন = Like that
তেমনি = As well
তেল = Oil
তেলাপোকা = Cockroach
তৈরি = Made up
তৈল = Oil
তৈলাক্ত = Oily
তোখড় = Mess
তোতলা = Parrot
তোতা = Stammer
তোমরা = You
তোমাকে = You
তোমায় = You
তোমার = Yours
তোয়াক্কা = Care
তোলপাড় = Commotion
তোলা = Picked up
তোশক = Mattress
তোষামোদ = Flattery
ত্বক = Skin
ত্বরণ = Acceleration
ত্যাগ = Give up
ত্যাগী = Sacrificer
ত্যাজ্য = Waste
ত্যাজ্যপুত্র = Prodigal son
ত্রাণ = Relief
ত্রাণকর্তা = Savior
ত্রাস = Terror
ত্রিকোণ = Triangle
ত্রিকোণমিতি = Trigonometry
ত্রিনয়ন = Trinity
ত্রিবিদ্যা = Trilogy
ত্রিবেদী = Trivedi
ত্রিভুজ = Triangle
ত্রিমাত্রিক = Three dimensional
ত্রিশূল = Trident
ত্রিসীমানা = Tri border
ত্রুটি = Error
ত্রুটিবিচ্যুতি = Error
থ = The seventeenth consonant of the Bengali alphabet
থমকানো = To stop
থমথম = Slow
থমথমে = Slowly
থরথর = Throbbing
থলে = Bag
থাকা = Stay
থানকুনি = 
থানা = Police station
থাপড় = Slap
থাপড়ানো = Pat
থাপ্পড় = Slap
থাবা = Paw
থামা = Stop
থু = Spit
থুথু = Spit
দ = The eighteenth consonant of the Bengali alphabet
দংশন = Sting
দই = Curd
দক্ষ = Skilled
দক্ষতা = Skills
দক্ষযজ্ঞ = Expert
দক্ষিণ = South
দখল = Possession
দখলদার = Occupier
দগ্ধ = Burned
দড়ি = Rope
দণ্ড = Penalty
দণ্ডনায়ক = Punisher
দণ্ডনীতি = Penal code
দণ্ডনীয় = Punishable
দণ্ডবিধান = Penal code 
দণ্ডবিধি = Penal code
দণ্ডায়মান = Standing
দত্তক = Adoption
দধি = Curd
দন্ত = Teeth
দন্তমূল = Tooth root
দফতর = Office
দফতরী = Office
দফা = Clause
দম = Breath
দমকল = Firefighter
দমকা = Gust
দমন = Suppression
দমনীয় = Oppressive
দমফাটা = Steam
দমবন্ধ = Suffocation
দম্পতি = Couple
দম্ভ = Pride
দয়া = Kindness
দয়াবান = Kind
দয়াময় = Benevolent 
দয়ালু = Kind
দয়াশীল = Benevolent
দর = Rate
দরকষাকষি = Negotiation
দরকার = Need
দরকারী = Useful
দরখাস্ত = Application
দরজা = Door
দরদ = Pity
দরদর = Bargain
দরদাম = Bargain
দরদী = Compassionate
দরাদরি = Bargain
দরিদ্র = Poor
দরিদ্রতা = Poverty
দরুন = Due to
দর্জি = Tailor
দর্পণ = Mirror
দর্শক = Audience
দর্শন = Philosophy
দর্শনশাস্ত্র = Philosophy
দল = Team
দলচ্যুত = Defection
দলছাড়া = Without party
দলপতি = Party leader
দলব = Team
দলবদ্ধ = Team up
দলবল = Team
দলভ্রষ্ট = Deviant
দলা = Faction
দলিল = Document
দলীয় = Party
দশ = Ten
দশক = Decade
দশমিক = Decimal
দশমী = Tenth
দশরথ = Dasaratha
দশা = State
দস্তক = Knock
দস্তা = Zinc
দস্তানা = Gloves
দস্যু = Bandit
দহন = Combustion
দাঁড়কাক = Raven
দাঁড়িপাল্লা = Scales
দাঁত = Teeth
দাখিল = Filed
দাগ = Stain
দাগকাটা = Spotted
দাঙ্গা = Riot
দাড়ি = Beard
দাতব্য = Charity
দাতা = Donor
দাদা = Grandfather
দান = Donation
দানপত্র = Donation letter
দানব = Monster
দানশীল = Charitable
দানা = Grain
দানাদার = Grainy
দাপট = Power
দাবা = Chess
দাবি = Claim
দাবিদার = Claimant
দাম = Price
দামী = Expensive
দাম্পত্য = Marriage
দাম্ভিক = Pretentious
দাম্ভিকতা = Pretentiousness
দায় = Responsibility
দায়গ্রস্ত = Guilty of
দায়দায়িত্ব = Responsibility
দায়মুক্ত = Exempt from liability
দায়মুক্তি = Impunity
দায়িত্ব = Responsibility
দায়িত্বজ্ঞান = Responsibility
দায়িত্ববোধ = Sense of responsibility
দায়ী = Responsible
দারচিনি = Cinnamon
দারিদ্র্য = Poverty
দারু = Alcohol
দারুচিনি = Cinnamon
দারুণ = Great
দারোগা = Policeman
দারোয়ান = Janitor
দার্শনিক = Philosopher
দালান = Building
দালাল = Broker
দাস = Slave
দাসত্ব = Slavery
দাসপ্রথা = Slavery
দাসী = Maid
দাহ্য = Inflammable
দিগন্ত = Horizon
দিন = Day
দিনমজুর = Day laborer
দিনরাত = Day and night
দিবস = Daily life
দিবা = Day
দিবারাত্রি = Day and night
দিবাস্বপ্ন = Daydream
দিব্যচক্ষু = Divine eye
দিব্যি = Swear
দিয়াশলাই = Matchbox
দিল্লী = Delhi
দিশা = Direction
দিশারী = Direction
দিশাহারা = Disoriented
দীপ্ত = Bright
দীপ্তি = Shine
দীর্ঘ = Long
দীর্ঘশ্বাস = Sigh
দুঃখ = Sadness
দুঃখিত = Sorry
দুঃশাসন = Misrule
দুঃসহ = Miserable
দুঃসাহসী = Adventurous
দুঃস্থ = Miserable
দুঃস্বপ্ন = Nightmare
দুকূল = Two
দুখানা = Both
দুগ্ধ = Milk
দুগ্ধপোষ্য = Dairy
দুধ = Milk
দুনিয়া = World
দুপুর = Noon
দুমড়ানো = To fold
দুমুঠো = Two hands
দুরন্ত = Fast
দুরবস্থা = Plight
দুরারোগ্য = Incurable
দুর্গ = Castle
দুর্গতি = Disaster
দুর্গন্ধ = Stench
দুর্গম = Inaccessible
দুর্ঘটনা = Accident
দুর্দম্য = Invincible
দুর্দশা = Distress
দুর্দশাগ্রস্ত = Distressed
দুর্দান্ত = Great
দুর্দিন = Hard
দুর্নাম = Bad name
দুর্নীতি = Corruption
দুর্বল = Weak
দুর্বিষহ = Miserable
দুর্বৃত্ত = Rogue
দুর্বোধ = Stupid
দুর্ভাগা = Unlucky
দুর্ভাগ্য = Bad luck
দুর্ভোগ = Suffering
দুর্যোগ = Disaster
দুর্লভ = Rare
দুল = Pendant
দুষি = Guilty
দুষ্কর্ম = Vice
দুষ্কৃতি = Misdemeanor
দুষ্টু = Mischievous
দূত = Messenger
দূর = Away
দূরত্ব = Distance
দূরদর্শন = Television
দূরদর্শী = Visionary
দূরীকরণ = Removal
দূর্বা = Grass
দূষণ = Pollution
দূষণীয় = Polluting
দূষিত = Polluted
দৃঢ় = Strong
দৃঢ়কণ্ঠ = Strong voice
দৃঢ়কল্প = Determination
দৃঢ়তা = Firmness
দৃঢ়প্রতিজ্ঞ = Determined
দৃঢ়ভক্তি = Devotion
দৃঢ়সংকল্প = Determination
দৃশ্য = Scene
দৃশ্যতঃ = Apparently
দৃশ্যমান = Visible
দৃষ্ট = Visible
দৃষ্টচর = Spectacle
দৃষ্টান্ত = Example
দৃষ্টি = Vision
দৃষ্টিহীন = Sightless
দেখাশুনা = Look after
দেদীপ্যমান = Bright
দেনা = Debt
দেনাপাওনা = Debt owed
দেবী = Goddess
দেয়াল = Wall
দেশত্যাগ = Emigration
দেশদ্রোহ = Treason
দেশপ্রেম = Patriotism
দেশবিখ্যাত = Nationally famous
দেশব্যাপী = Nationwide
দেশভক্ত = Patriotic
দেশমাতৃকা = Motherland
দেশাত্মবোধ = Patriotism
দেশান্তর = Emigration
দেশীয় = Domestic
দেহ = Body
দেহকোষ = Body cells
দেহক্ষয় = Loss of body
দেহত্যাগ = Abdication
দেহধারণ = Body
দৈত্য = Monster
দৈনিক = Daily
দৈন্য = Miserable
দৈন্যদশা = Plight
দৈব = Divine
দৈবঘটনা = Accident
দৈর্ঘ্য = Length
দৈহিক = Physical
দোকান = Shop
দোকানদার = Shopkeeper
দোকানপাট = Shopping
দোতরফা = Bilateral
দোতলা = Two storied
দোদুল্যমান = Wavering
দোয়াত = Ink
দোয়েল = Magpie
দোল = Swing
দোলনা = Swing
দোষ = Blame
দোষারোপ = Blame
দৌড় = Running
দৌড়প্রতিযোগিতা = Race
দ্বন্দ্ব = Conflict
দ্বাদশ = Twelfth
দ্বারস্থ = At the gate
দ্বারা = By
দ্বিখণ্ডিত = Bifurcated
দ্বিঘাত = Quadratic
দ্বিতীয় = Second
দ্বিধা = Dilemma
দ্বিধাগ্রস্ত = Confused
দ্বিপদ = Binomial
দ্বিপদী = Binomial
দ্বিপাক্ষিক = Bilateral
দ্বিপ্রহর = Two o'clock
দ্বীপ = Island
দ্বৈত = Double
দ্ব্যর্থ = Ambiguous
দ্যোতক = Seer
দ্রব = Liquid
দ্রবণ = Solution
দ্রবণীয় = Soluble
দ্রবীকরণ = Dissolution
দ্রবীভূত = Dissolve
দ্রব্য = Goods
দ্রব্যমূল্য = Commodity price
দ্রব্যসামগ্রী = Goods
দ্রষ্টব্য = Note
দ্রাঘিমা = Longitudinal
দ্রাঘিমারেখা = Longitude
দ্রাবক = Solvent
দ্রাব্য = Soluble
দ্রুত = Quickly
দ্রুতগতি = Speed
দ্রুততা = Speed
দ্রুতি = Fast
দ্রোহ = Treachery
ধ = The nineteenth consonant of the Bengali alphabet
ধড়িবাজ = Shrill
ধন = Wealth
ধনগৌরব = Glory
ধনিয়া = Coriander
ধনিয়াপাতা = Coriander leave
ধনী = Rich
ধনুক = Bow
ধনেপাতা = Cilantro
ধন্য = Blessed
ধন্যবাদ = Thank you
ধবধবে = White
ধবল = White
ধমনী = Artery
ধরন = Type
ধরা = Caught
ধরাধরি = Get caught
ধরানো = Catch
ধরি = Catch up
ধর্ম = Religion
ধর্মচর্চা = Religious practice
ধর্মত্যাগ = Apostasy
ধর্মপরায়ণ = Pious
ধর্মপালন = Religion
ধর্মপ্রাণ = Devout
ধর্মযুদ্ধ = Religious war
ধর্মীয় = Religious
ধর্ষণ = Rape
ধর্ষিত = Raped
ধর্ষিতা = Raped
ধাওয়া = Chase
ধাক্কা = Push
ধাত = Metal
ধাতব = Metallic
ধাতু = Metal
ধাত্রী = Midwife
ধান = Paddy
ধান্ধা = Puzzle
ধাপ = Step
ধাপ্পা = Step
ধাপ্পাবাজ = Cheater
ধাবধাড়া = Rush
ধাবমান = Flow
ধাবিত = Running
ধামাচাপা = Cover up
ধার = Borrow
ধারক = Container
ধারা = Clause
ধারালো = Sharp
ধার্মিক = Pious
ধার্য = Hold up
ধিক্কার = Damn it
ধীর = Slow 
ধুয়া =  wash
ধুর্য = Damn
ধুলো = Dust
ধূমকেতু = Comet
ধূমপান = Smoking
ধূমপায়ী = Smoker
ধূমায়িত = Smoky
ধূর্ত = Cunning
ধূসর = Gray
ধৈর্য = Patience
ধৈর্যধারণ = Patience
ধৈর্যশীল = Patient
ধৈর্যহারা = Impatient
ধোঁকা  = Cheat
ধোঁকাবাজ = Cheater
ধোঁয়াটে = Smoky
ধোপা = Laundry
ধোয়া = Wash
ধোলাই = Wash
ধৌত = Washed
ধ্বংস = Destruction
ধ্বংসলীলা = Destruction
ধ্বংসাবশেষ = Ruins
ধ্বনিত = Sound
ধ্বন্যাত্মক = Phonetic
ধ্যান = Meditation
ধ্রুব = Constant
ধ্রুবক = Constant
ন = The twentieth letter of the Bengali alphabet
নওজোয়ান = Young man
নকল = Fake
নকশা = Design
নকশী = Design
নক্ষত্র = Star
নখ = Nails
নখর = Claw
নগণ্য = Insignificant
নগদ = Cash
নগর = City
নগরী = City
নগ্ন = Naked
নজর = Glance
নজরদারি = Surveillance
নজরবন্দী = Under observation
নড়চড় = Move
নড়বড় = Shaky
নড়া = Move
নড়াচড়া = Movement
নত = Bent down
নতজানু = Kneel down
নতমস্তক = Bow down
নতমুখ = Downcast
নতি = Surrender
নতিস্বীকার = Give up
নতুন = New
নতুবা = Or
নথি = Document
নথিরক্ষক = Record keeper
নদী = River
নদীতট = River bank
নদীবহুল = Riverine
নদীমাতৃক = Riverine
নপুংসক = Impotent
নব = New
নবজাতক = Newborn
নববধূ = Bride
নববর্ষ = New year
নবাব = Nawab
নবী = Prophet
নমনীয় = Flexible
নমস্কার = Hello
নমুনা = Sample
নম্র = Humble
নয়তো = Or else
নয়ন = Eyes
নয়নগোচর = Visible
নয়া = New
নর = Male
নরক = Hell
নরম = Soft
নর্তকী = Dancer
নল = Tube
নলকূপ = Tube well
নলখাগড়া = Reed
নষ্ট = Wasted
না = No
নাক = Nose 
নাকচ = Refuse
নাগ = Serpent
নাগরিক = Citizen
নাগাল = Reach
নাচ = Dance
নাটক = Drama
নাটকীয় = Dramatic
নাট্য = Drama
নাট্যশালা = Theater
নাড়া = Shake
নাড়ী = Pulse
নাড়ীভুঁড়ি = Pulse
নাতজামাই = Son-in-law
নাতনী = Granddaughter
নাতি = Grandson
নাতিদীর্ঘ = Temperate
নানা = Grandpa
নানী = Grandma
নাব্য = Navy
নাভি = Navel
নাম = Name
নামকরণ = Nomenclature
নামলাম = Got down
নামাজ = Prayer
নারী = Woman
নালিশ = Complaint
নালী = Conduit
নাশক = Destroyer
নাশতা = Breakfast
নাসারন্ধ্র = Nostrils
নাস্তা = Breakfast
নাস্তানাবুদ = Breakfast
নাস্তিক = Atheist
নিংড়ানো = Squeeze
নিঃশব্দ = Silent
নিঃশর্ত = Unconditionally
নিঃশেষ = Endless
নিঃশ্বাস = Breath
নিঃসঙ্গ = Alone
নিঃসন্তান = Childless
নিঃসন্দেহ = Undoubtedly
নিঃসৃত = Discharged
নিঃস্ব = Destitute
নিউমোনিয়া = Pneumonia
নিকট = Near
নিকাশ = Drainage
নিকৃষ্ট = Inferior
নিক্ষিপ্ত = Thrown
নিক্ষেপ = Throw
নিখুঁত = Perfect
নিখোঁজ = Missing
নিচু = Low
নিজস্ব = Own
নিতান্ত = Absolutely
নিত্য = Everyday
নিথর = Frozen
নিদারুণ = Desperately
নিদিষ্ট = Certain
নিদ্রা = Sleep
নিদ্রাগত = Sleepy
নিদ্রাশীল = Sleepy
নিদ্রিত = Asleep
নিধি = Treasure
নিন্দা = Condemnation
নিপীড়ন = Persecution
নিপীড়িত = Oppressed
নিপুণ = Skillful
নিবদ্ধ = Focused
নিবন্ধন = Registration
নিবারণ = Prevention
নিভানো = Extinguish
নিমজ্জিত = Submerged
নিমন্ত্রণ = Invitation
নিমিত্ত = For the sake of
নিমেষ = Momentarily
নিম্ন = Lower
নিম্নগামী = Downward
নিম্নবর্তী = Following
নিম্নলিখিত = Following
নিম্নোক্ত = Following
নিয়ত = Destiny
নিয়ন্ত্রক = Controller
নিয়ম = Rules
নিয়মকানুন = Regulations
নিয়মাধীন = Under the rules
নিয়মানুবর্তিতা = Discipline
নিয়মিত = Regular
নিয়োগ = Recruitment
নিরক্ষর = Illiterate
নিরপরাধ = Innocent
নিরবচ্ছিন্ন = Uninterrupted
নিরবদ্য = Timeless
নিরবধি = Timeless
নিরর্থক = In vain
নিরাপদ = Safe
নিরামিষ = Vegetarian
নিরাশ = Disappointed
নিরিবিলি = Quiet
নিরীক্ষণ = Monitoring
নিরীহ = Harmless
নিরুপায় = Unrepentant
নিরূপণ = Assessment
নিরেট = Completely
নির্গত = Released
নির্গমন = Emissions
নির্ঘাত = Unstoppable
নির্জন = Lonely
নির্জলা = Waterless
নির্জীব = Inanimate
নির্ঝর = Clear
নির্ণয় = Diagnosis
নির্ণয়কারী = Determinant
নির্ণয়ন = Diagnosis
নির্ণায়ক = Decisive
নির্ণীত = Determined
নির্ণেয় = Determinable
নির্দয় = Merciless
নির্দিষ্ট = Specific
নির্দেশ = Instructions
নির্দোষ = Innocent
নির্ধারণ = Determine
নির্ধারিত = Prescribed
নির্বাক্‌ = Speechless
নির্বাচন = Election
নির্বাপণ = Extinction
নির্বাসন = Exile
নির্বাহ = Execution
নির্বাহী = Executive
নির্বিকল্প = Optional
নির্বিকার = Without hesitation
নির্বিঘ্ন = Seamless
নির্বিচার = Arbitrary
নির্বিশেষে = Regardless
নির্বুদ্ধি = Stupid
নির্বোধ = Silly
নির্ভর = Dependent
নির্ভীক = Fearless
নির্ভুল = Accurate
নির্মম = Ruthless
নির্মল = Serene
নির্মাণ = Construction
নির্মাতা = Maker
নির্মিত = Constructed
নির্মূল = Eliminated
নির্যাতন = Torture
নির্যাতিত = Tortured
নির্যাস = Extract
নির্লজ্জ = Shameless
নিলাম = Took
নিশাচর = Nocturnal
নিশান = Target
নিশানা = Target
নিশি = Night
নিশ্চয় = Sure
নিশ্চয়তা = Assurance
নিশ্চল = Still
নিশ্চিন্ত = Rest assured
নিশ্বাস = Breath
নিষিক্ত = Fertilized
নিষেধ = Forbidden
নিষ্কর্মা = Idle
নিষ্কলঙ্ক = Spotless
নিষ্কৃতি = Absolution
নিষ্ক্রিয় = Inactive
নিষ্ঠা = Loyalty
নিষ্ঠুর = Cruel
নিষ্পত্তি = Disposal
নিষ্পাপ = Innocent
নিষ্প্রাণ = Lifeless
নিষ্ফল = In vain
নিসর্গ = Nature
নিস্তব্ধ = Silent
নিস্তার = Passover
নিস্তেজ = Dull
নিস্রাব = Urination
নিহত = Killed
নীচ = Below
নীচু = Low
নীড় = Nest
নীতি = Policy
নীতিকথা = Policy
নীতিবাক্য = Motto
নীতিশাস্ত্র = Ethics
নীরব = Silent
নীরস = Monotonous
নীরোগ = Disease
নীল = Blue
নীলা = Blue
নীহারিকা = Nebula
নুড়ি = Gravel
নুন = Salt
নুর = Light
নূতন = New
নূর = Light
নৃতত্ত্ব = Anthropology
নৃত্য = Dance
নৃত্যশালা = Dance hall
নৃপতি = Actor
নৃবিদ্যা = Anthropology
নৃশংস = Brutal
নেই = No
নেকড়ে = Wolf
নেকামি = Evil
নেকী = Virtue
নেতা = Leader
নেতিবাচক = Negative
নেতৃত্ব = Leadership
নেত্র = Eyes
নেত্রগোচর = Visible
নেপথ্য = Backstage
নেভানো = Take off
নেয়া = Take
নেশা = Addiction
নেশাখোর = Drug addict
নেশাগ্রস্ত = Intoxicated
নৈকট্য = Proximity
নৈপুণ্য = Craft
নোংরা = Dirty
নোংরামি = Dirtiness
নোঙ্গর = Anchor
নোটখাতা = Notice
নোটিশ = Notice
নোনতা = Salty
নোনা = Salty
নৌকা = Boat
নৌচালক = Sailor
নৌবহর = Fleet
নৌবাহিনী = Navy
নৌবাহী = Ship
ন্যস্ত = Vest
ন্যাংটা = Naked
ন্যাকড়া = Rag
ন্যায্য = Fair
ন্যায় = Justice
ন্যায়দণ্ড = Justice
ন্যায়পরায়ণ = Just
ন্যায়বান = Righteous
ন্যায়বিচার = Justice
ন্যায়বুদ্ধি = Justice
ন্যায়সঙ্গত = Justified
ন্যায়সম্মত = Fair
ন্যূনতম = Minimum
প = The twenty first consonant of the Bengali alphabet
পকেট = Pocket
পকেটঘড়ি = Pocket watch
পক্ষ = Side
পক্ষী = Bird
পঙ্গু = Crippled
পচন = Decomposition
পচা = Rotten
পছন্দ = Choice
পঞ্জিকা = Calendar
পট = Pot
পড়া = Read
পণ = Bet
পণ্ডশ্রম = Fruitless toil
পণ্ডিত = Scholar
পতঙ্গ = Insect
পতন = Collapse
পতনশীল = Falling
পতিতা = Prostitute
পতিতালয় = Brothel
পতিত্ব = Fatherhood
পত্নী = Spouse
পত্র = Letter
পত্রপাঠ = Correspondence
পথ = Way
পথভ্রষ্ট = Misguided
পদ = Post
পদতল = Underfoot
পদত্যাগ = Resignation
পদমর্যাদা = Rank
পদযুগল = Foot couple
পদার্থ = Substance
পদার্থবিজ্ঞান = Physics
পদ্ধতি = Method
পদ্ম = Lotus
পদ্মা = Padma
পন্থা = Approach
পয়সা = Money
পর = After
পরওয়ানা = License
পরকাল = Hereafter
পরকীয়া = Foreigner
পরখ = Check
পরমাণু = Atom
পরলোক = Afterlife
পরশপাথর = Philosopher's stone
পরশু = Day after tomorrow
পরস্পর = Each other
পরাধীন = Subject to
পরামর্শ = Advice
পরিক্রম = Circuit
পরিক্রমণ = Alternation
পরিখা = Trench
পরিচালনা = Management
পরিচিত = Known
পরিণত = Become
পরিণতি = Consequence
পরিতৃপ্তি = Satisfaction
পরিধান = Wear
পরিপাটি = Neat
পরিবর্জিত = Modified
পরিবর্তন = Change
পরিবর্ধন = Amplification
পরিবহন = Transport
পরিবার = Family
পরিবৃতি = Change
পরিবেশ = Environment
পরিবেশন = Serving
পরিবেষ্টনী = Environment
পরিব্যক্ত = Explained
পরিব্যাপ্ত = Pervading
পরিব্রাজক = Traveler
পরিভাষা = Terminology
পরিমাপ = Measurement
পরিমাপক = Gauge
পরিমাপন = Measurement
পরিমিত = Moderate
পরিমিতি = Limit
পরিমেয় = Moderate
পরিলিখিত = Described
পরিশুদ্ধি = Purification
পরিশেষ = Finally
পরিশেষে = Finally
পরিশোধ = Payment
পরিশ্রম = Hard work
পরিশ্রান্ত = Exhausted
পরিষ্কার = Clear
পরিসংখ্যান = Statistics
পরিসমাপ্তি = Termination
পরিসর = Range
পরিসীমা = Range
পরিস্থিতি = Situation
পরিস্ফুট = Clear
পরিহার = Avoidance
পরিহাস = Irony
পরী = Fairy
পরীক্ষক = Examiner
পরীক্ষা = Test
পরোক্ষ = Indirect
পরোয়া = Care
পরোয়ানা = Warrant
পর্দা = Screen
পর্ব = Episode
পর্বত = Mountain
পর্যটক = Tourist
পর্যটন = Tourism
পর্যন্ত = Up to
পর্যবেক্ষণ = Observation
পর্যাপ্ত = Enough
পর্যাবৃত্ত = Circle
পর্যায় = Stage
পলক = Wink
পলকহীন = Unblinking
পলাতক = Fugitive
পলানো = Run away
পলিমাটি = Alluvial soil
পল্লী = Countryside
পশম = Fur
পশমী = Woolly
পশু = Animal
পশুচারণ = Animal husbandry
পশুচারণভূমি = Pasture land
পশুপালন = Animal husbandry
পশ্চাদ্‌গামী = Backwards
পশ্চিম = West
পশ্চিমবঙ্গ = West Bengal
পসরা = Spread out
পা = Leg
পাঁজর = Ribs
পাংশু = Animal
পাইপ = Pipe
পাউডার = Powder
পাউন্ড = Pounds
পাউরুটি = Bread
পাওনা = Owed
পাওনাদার = Creditor
পাওয়া = Found
পাকঘর = Kitchen
পাকড়াও = Catch up
পাকড়ানো = Get hold of
পাকস্থলী = Stomach
পাকা = Seasoned
পাক্ষিক = Fortnightly
পাখী = Bird
পাগল = Crazy
পাগলামি = Madness
পাজি = Scoundrel
পাটাতন = Deck
পাঠক = Reader
পাঠশালা = Classroom
পাঠ্য = Text
পাঠ্যক্রম = Curriculum
পাঠ্যতালিকা = Textbook
পাঠ্যপুস্তক = Textbook
পাঠ্যসূচী = Syllabus
পাঠ্যাবস্থা = Curriculum
পাড় = Edge
পাড়া = Neighborhood
পাণ্ডব = The Pandavas
পাণ্ডা = Panda
পাণ্ডিত্য = Erudition
পাণ্ডুলিপি = Manuscript
পাতা = Leaf
পাতাবাহার = Leafy
পাত্তা = Don't care
পাত্র = Pot
পাথর = Stone
পান = Drink
পানকৌড়ি = Pankauri
পানা = Leaf
পানি = Water
পানীয় = Drink
পাপ = Sin
পাপকর্ম = Sin
পাপড়ি = Petals
পাপবুদ্ধি = Sinfulness
পাপাচার = Wickedness
পাপাত্মা = Sin
পাপিষ্ঠ = Sinful
পাপী = Sinner
পাম্প = Pump
পায়জামা = Pajamas
পায়রা = Pigeon
পায়ু = Anus
পারদ = Mercury
পারদর্শী = Adept
পারস্পরিক = Mutual
পারিতোষিক = Rewarding
পারিপার্শ্বিক = Surroundings
পারিশ্রমিক = Remuneration
পার্ক = Park
পার্থক্য = Difference
পার্থিব = Worldly
পার্বণ = Parvan
পার্লামেন্ট = Parliament
পার্সেল = Parcel
পালঙ্ক = Couch
পাশ্চাত্য = Western
পাষাণ = Rock
পাহাড় = Mountain
পাহারা = Guard
পাহারাওয়ালা = Guard
পিঁপড়া = Ant
পিঁয়াজ = Onion
পিছু = After
পিছুটান = Push back
পিতল = Brass
পিতা = Father
পিতামহ = Grandfather
পিতৃ = Father
পিত্ত = Bile
পিত্তাশয় = Gall bladder
পিন = Pin
পিপাসা = Thirst
পিপীলিকা = Ant
পিয়ন = Peon
পিরামিড = Pyramid
পিশাচ = Ghost
পিষা = Grind
পীড়া = Suffering
পীত = Drunk
পুঁজিবাদী = Capitalist
পুংলিঙ্গ = Masculine
পুকুর = Pond
পুঞ্জীভূত = Accumulated
পুণ্য = Virtue
পুণ্যবান = Virtuous
পুতুল = Doll
পুতুলনাচ = Puppetry
পুত্র = Son
পুত্রবধূ = Daughter-in-law
পুদিনা = Mint
পুনরাবৃত্তি = Repeat
পুনর্জন্ম = Reincarnation
পুনশ্চ = Again
পুরস্কার = Reward
পুরাকাল = Ancient times
পুরাণ = Mythology
পুরুষত্ব = Manhood
পুলিস = Police
পুষ্টি = Nutrition
পুষ্টিদান = Nutrition
পুষ্প = Flower
পুস্তিকা = Booklet
পূজা = Worship
পূর্ণ = Full of
পূর্ণতা = Fullness
পূর্ণাঙ্গ = Complete
পূর্ণিমা = Full moon
পূর্তি = Fulfillment
পৃষ্ঠপোষকতা = Patronage
পৃষ্ঠা = Page
পেঁচা = Owl
পেঁপে = Papaya
পেটুক = Gluttony
পেশা = Occupation
পেশী = Muscle
পোস্ট = Post
পোস্টঅফিস = Post office
পোস্টকার্ড = Postcard
পোস্টমাস্টার = Postmaster
পোহানো = Put on
পৌঁছানো = To reach
পৌষ্টিকতন্ত্র = Nutritional system
প্যান্ট = Pants
প্যারাশুট = Parachute
প্যাসেঞ্জার = Passenger
প্রকট = Obvious
প্রকম্প = Trembling
প্রকল্প = Project
প্রকাণ্ড = Huge
প্রকার = Type
প্রকাশ = Disclosure
প্রকাশ্য = Public
প্রকৃত = Genuine
প্রকৃতি = Nature
প্রকৃষ্ট = Excellent
প্রকোষ্ঠ = Chamber
প্রক্রিয়া = Process
প্রগতি = Progress
প্রগতিশীল = Progressive
প্রচার = Propaganda
প্রচুর = A lot
প্রজা = People
প্রজ্ঞা = Wisdom
প্রতাপ = Glory
প্রতাপশালী = Majestic
প্রতারক = Cheater
প্রতি = Per
প্রতিক্রিয়া = Response
প্রতিক্ষণ = Every time
প্রতিঘাত = Resistance
প্রতিজ্ঞা = Promise
প্রতিদান = Compensation
প্রতিদিন = Every day
প্রতিনিধি = Representative
প্রতিপন্ন = Gifted
প্রতিপাদ্য = Motto
প্রতিফলন = Reflection
প্রতিবন্ধক = Barrier
প্রতিবন্ধী = Disabled
প্রতিবাদ = Protest
প্রতিবিম্ব = Reflection
প্রতিবেশী = Neighbor
প্রতিভা = Genius
প্রতিমা = Idol
প্রতিরক্ষা = Defense
প্রতিরূপ = Replica
প্রতিলিপি = Copy
প্রতিশ্রুতি = Promise
প্রতিষ্ঠা = Establishment
প্রতিষ্ঠান = Institution
প্রতীক = Symbol
প্রতীক্ষা = Waiting
প্রতুল = Sufficient
প্রত্নবিদ্যা = Archeology
প্রত্যক্ষ = Direct
প্রত্যঙ্গ = Limbs
প্রত্যয় = Conviction
প্রত্যহ = Every day
প্রত্যাশা = Expectation
প্রত্যাহার = Withdrawal
প্রত্যুক্তি = Replication
প্রত্যুত্তর = Reply
প্রথম = First
প্রথা = Tradition
প্রদক্ষিণ = Circle
প্রদর্শন = Display
প্রদর্শনী = Exhibition
প্রদান = Provide
প্রদাহ = Inflammation
প্রদীপ = Lamp
প্রদীপ্ত = Bright
প্রদেশ = Province
প্রধান = Chief
প্রপাত = Falls
প্রফুল্ল = Cheerful
প্রবক্তা = Advocate
প্রবচন = Proverb
প্রবন্ধ = Essay
প্রবল = Strong
প্রবাদ = Proverb
প্রবাহ = Flow
প্রবৃদ্ধ = Grown up
প্রবেশ = Entrance
প্রভা = Light
প্রভাত = Morning
প্রভাব = Effect
প্রভু = Lord
প্রভেদ = Difference
প্রমাণ = Evidence
প্রমোদ = Joy
প্রযুক্ত = Applied
প্রয়াত =l ate
প্রয়োগ = Application
প্রয়োজন = Need
প্ররোচক = Persuasive
প্ররোচনা = Persuasion
প্রলাপ = Delirium
প্রলুব্ধ = Tempt
প্রলেপ = Coating
প্রলোভ = Temptation
প্রশংসনীয় = Admirable
প্রশংসা = Praise
প্রশংসিত = Appreciated
প্রশস্ত = Spacious
প্রশাখা = Department
প্রশান্তি = Tranquility
প্রশিক্ষণ = Training
প্রশ্ন = Question
প্রশ্রয় = Indulgence
প্রসন্ন = Happy
প্রসব = Childbirth
প্রসাধন = Decoration
প্রসারী = Expansive
প্রসিদ্ধ = Famous
প্রসূতি = Obstetrics
প্রস্তাব = Offer
প্রস্তাবনা = Proposal
প্রস্তুত = Ready
প্রস্থ = Width
প্রস্থান = Departure
প্রস্ফুট = Bloom
প্রস্রাব = Urine
প্রহর = Watch
প্রহসন = Farce
প্রহার = Beating
প্রহেলিকা = Puzzle
প্রাইজ = Prize
প্রাইভেট = Private
প্রাইমারি = Primary
প্রাচীন = Ancient
প্রাচীর = Wall
প্রাচুর্য = Abundance
প্রাচ্য = East
প্রাণ = Soul
প্রাণী = Animals
প্রাত = Morning
প্রাতরাশ = Breakfast
প্রাথমিক = Primary
প্রাদেশিক = Provincial
প্রান্তর = Wilderness
প্রান্তিক = Marginal
প্রাপক = Recipient
প্রাপ্ত = Received
প্রাপ্তি = Receiving
প্রাপ্য = Deserved
প্রায় = Almost
প্রারম্ভ = Beginning
প্রার্থনা = Prayer
প্রার্থী = Candidate
প্রাসঙ্গিক = Relevant
প্রাসাদ = Palace
প্রিন্টার = Printer
প্রিন্সিপাল = Principal
প্রিয় = Beloved
প্রিয়জন = Beloved
প্রিয়তম = Darling
প্রীতি = Love
প্রেক্ষা = Scene
প্রেত = Ghost
প্রেতাত্মা = Ghost
প্রেম = Love
প্রেরক = Sender
প্রেসক্রিপ্‌শন = Prescription
প্রেসিডেন্ট = President
প্রোগ্রাম = Program
প্রৌঢ় = Adult
প্লবতা = Buoyancy
প্লাবন = Flood
প্লীহা = Spleen
প্লেট = Plate
প্লেন = Plane
প্ল্যান = Plan
ফ = The twenty second consonant of the Bengali alphabet
ফকির = Poor
ফটক = Gate
ফটো = Photo
ফটোগ্রাফ = Photograph
ফড়িং = Grasshopper
ফন্দি = Plan
ফরমাশ = Order
ফর্দ = List
ফর্ম = Form
ফর্সা = Fair
ফল = Fruit
ফলক = Yield
ফলন = Fruitful
ফলপ্রসূ = Result
ফলশ্রুতি = Shed
ফসল = Crop
ফাঁক = Gap
ফাঁকি = Cheat
ফাঁকিবাজ = Evasive
ফাঁড়ি = Outpost
ফাঁদ = Trap
ফাঁপা = Hollow
ফাঁস = Leaked
ফাঁসি = Hanging
ফাইন = Fine
ফাগুন = Fagun
ফাটল = Cracked
ফায়দা = Benefit
ফালতু = Nonsense
ফাল্গুন = Falgun
ফি = Fee
ফিটকিরি = Anthill
ফিটফাট = Fit
ফিতা = Ribbon
ফিতাকৃমি = Tapeworm
ফিরত = Returned
ফিরা = Return
ফিস্‌ফিস্‌ = Whisper
ফুরসত = Free
ফুল = Flowers
ফুলপ্যান্ট = Full pants
ফুলহাতা = Full sleeve
ফুলানো = Swell
ফুসফুস = Lungs
ফেনা = Foam
ফেরত = Refund
ফেরানো = Return
ফেরিওয়ালা = Hawker
ফোটে = Bloom
ফোটো = Photo
ফোটোগ্রাফ = Photograph
ফোট্‌ = Bloom
ফোড়ন = Boil
ফোড়া = Abscess
ফোন = Phone
ফোনবুথ = Phone booth
ফোয়ারা = Fountain
ফোলা = Swollen
ফৌজ = Army
ফৌজদারি = Criminal
ফ্যাকাসে = Pale
ফ্যাশন = Fashion
ফ্রী = Free
ফ্রেম = Frame
ফ্ল্যাট = Flat
ব = The twenty third consonant of the Bengali alphabet
বঁধু = Wife
বংশ = Ancestry
বংশগত = Hereditary
বংশপরম্পরা = Hereditary
বংশবৃদ্ধি = Breeding
বংশমর্যাদা = Pedigree
বই = Book
বউ = Wife
বকধার্মিক = Eloquent
বকশিস = Gratuity
বকাচ্ছেন = Scolding
বকা = Stupid
বক্তব্য = Speech
বক্তৃতা = Speech
বক্র = Curve
বক্রতা = Curvature
বক্রদৃষ্টিতি = Astigmatism
বক্ষ = Chest
বগল = Armpit
বগি = Compartment
বঙ্গ = Bengal
বঙ্গদেশ = Bangladesh
বঙ্গবাসী = Bengali
বঙ্গভঙ্গ = Division of Bengal
বচন = Speech
বছর = Year
বজরা = Bajra
বজায় = Maintained
বজ্র = Thunder
বজ্রধ্বনি = Thunder
বটপাতা = Banyan leaves
বটবৃক্ষ = Banyan tree
বড্ড = A lot
বড় = Big
বড়লোক = Big guy
বণিক = Merchant
বণ্টন = Distribution
বদ = Bad
বদমাশ = Rogue
বদমেজাজ = In a bad mood
বদমেজাজী = Bad temper
বদরাগী = Angry
বদল = Change
বদলী = Replacement
বদহজম = Indigestion
বদ্ধ = Closed
বদ্ধমূল = Rooted
বদ্বীপ = Delta
বধ = Slaughter
বধির = Deaf
বধূ = Bride
বন = Forest
বনজঙ্গল = Forest
বনবাসী = Forest dweller
বনভোজন = Picnic
বনমানুষ = Ape
বনমোরগ = Wild Rooster
বন্দনা = Captive
বন্দী = Prisoner
বন্দীশালা = Prison
বন্দুক = Gun
বন্দেগী = Servant
বন্দোবস্ত = Settlement
বন্ধ = Off
বন্ধন = Bond
বন্ধনী = Parentheses
বন্ধু = Friend
বন্ধুত্ব = Friendship
বন্ধুত্বপূর্ণ = Friendly
বন্ধ্যা = Infertile
বন্য = Wild
বন্যা = Flood
বপন = Sowing
বমন = Vomiting
বমি = Vomit
বয়কট = Boycott
বয়স = Age
বয়স্ক = Older
বয়ান = Speech
বয়াম = Jar
বয়োজ্যেষ্ঠ = Senior
বর = Groom
বরং = Rather
বরকত = Blessing
বরখাস্ত = Dismissed
বরণ = Reception
বরদাস্ত = Tolerable
বরপক্ষ = Groom
বরফ = Ice
বরবধূ = Bride
বরবাদ = Blessing
বরযাত্রী = Bridegroom
বরাদ্দ = Allocation
বরাবর = Along with
বরেণ্য = Elite
বর্গ = Square
বর্গমূল = Square root
বর্গী = Square
বর্গীয় = Square
বর্জন = Exclusion
বর্জনীয় = Excluded
বর্জিত = Devoid of
বর্জ্য = Waste
বর্ণ = Color
বর্ণচোরা = Color thief
বর্ণজ্ঞান = Color knowledge
বর্ণজ্ঞানহীন = Colorless
বর্ণনা = Description
বর্ণনাতীত = Indescribable
বর্ণমালা = Alphabet
বর্ণহীন = Colorless
বর্ণান্ধ = Color blind
বর্ণান্ধতা = Blindness
বর্ণালী = Spectrum
বর্তন = Rotation
বর্তমান = Current
বর্ধিত = Extended
বর্ম = Armor
বর্শা = Spear
বর্ষ = Year
বর্ষজীবী = Perennial
বর্ষণ = Rain
বর্ষপূর্তি = Anniversary
বর্ষা = Monsoon
বর্ষাকাল = Rainy season
বলদ = Ox
বলবিদ্যা = Force
বলয় = Ring
বলল = Said
বললাম = Said
বলশালী = Strong
বলহীন = Powerless
বলা = Say
বলিরেখা = Wrinkles
বলিষ্ঠ = Strong
বলী = Sacrifice
বশ = Tame
বশত = Due to
বশীকরণ = Subjugation
বশীভূত = Subdued
বশ্যতা = Submission
বসন = Sit down
বসন্ত = Spring
বসা = Sit down
বস্তা = Sack
বস্তি = Slum
বস্তু = Object
বস্ত্র = Clothes
বস্ত্রহরণ = Undress
বহন = Carry
বহর = Fleet
বহাল = Maintained
বহিরাগত = External
বহির্গত = External
বহির্ভূত = Excluded
বহু = Many
বহুত = A lot
বহুদিন = Many days
বহুদূর = Far
বহুবিধ = Multiple
বহুবিবাহ = Polygamy
বহুরূপী = Polymorphic
বহুল = A lot
বা = Or
বাঁক = Bend
বাঁকা = Curved
বাঁচা = Save
বাঁচি = Live
বাঁটন = Button
বাঁটোয়ারা = Distribution
বাঁদর = Monkey
বাঁদরনাচ = Monkey dance
বাঁদরামি = Monkey
বাঁধ = Dam
বাঁধন = Binding
বাঁধা = Tied up
বাঁধাধরা = Restraint
বাঁধানো = Tie up
বাঁপাশ = Left
বাঁশ = Bamboo
বাঁশঝাড় = Bamboo
বাঁশি = Flute
বাংলা = Bangla
বাংলাদেশ = Bangladesh
বাইসিকেল = Bicycle
বাক = Speech
বাকী = Rest
বাক্য = Sentence
বাক্যবিশারদ = Phraseologist
বাক্যালাপ = Conversation
বাক্স = Box
বাক্সবন্দী = Boxed
বাগিচা  =garden
বাঘ = Tiger
বাঙাল = Bengal
বাঙালী = Bengali
বাচক = Reader
বাচন = Speech
বাচনভঙ্গি = Manner of speech
বাচ্চা = Baby
বাছা = Baby
বাজ = Lightning
বাজনা = Playing
বাজা = Play
বাজার = Market
বাজুবন্ধ = Arms
বাঞ্ছনীয় = Recommended
বাঞ্ছা = Wish
বাঞ্ছিত = Desirable
বাটখারা = Batkhara
বাটি = Bowl
বাড়ন্ত = Growing up
বাড়া = Increase
বাড়ি = Home
বাড়িওয়ালা = Landlord
বাড়িঘর = House
বাণ = Arrows
বাণবিদ্ধ = Shot through
বাণিজ্য = Trade
বাণী = Word
বাতাবরণ = Atmosphere
বাতাস = Wind
বাতি = Lamp
বাতিক = Whimsy
বাতিকগ্রস্ত = Whimsical
বাতিঘর = Lighthouse
বাতিল = Canceled
বাদ = Except
বাদক = Musician
বাদন = Playing
বাদশা = King
বাদশাহ = King
বাদশাহী = King
বাদাম = Nuts
বাদামী = Brown
বাদিত = Said
বাদী = Plaintiff
বাদুড় = Bat
বাদ্য = Music
বাদ্যযন্ত্র = Musical instruments
বাধ = Barrier
বাধা = Barrier
বাধাদান = Obstruction
বাধিত = Obliged
বাধ্য = Forced
বাধ্যতামূলক = Compulsory
বানর = Monkey
বান্দা = Servant
বাপ = Father
বাবলা = Acacia
বাবা = Father
বাবু = Baby
বাবুর্চি = Cook
বাম = Left
বামন = Dwarf
বামপন্থা = Left wing
বামুন = Dwarf
বায়না = Serious
বায়নাপত্র = Affidavit
বায়বীয় = Aerial
বায়স্কোপ = Binoculars
বায়ু = Air
বায়ুগ্রস্ত = Suffocated
বায়ুচাপ = Air pressure
বায়ুপ্রবাহ = Airflow
বায়ুমণ্ডল = Atmosphere
বার = Times
বারণ = Ban
বারবার = Repeatedly
বারান্দা = Balcony
বারুদ = Gunpowder
বার্তা = Message
বার্তাজীবী = Messenger
বার্তাবহ = Messenger
বার্তাবহন = Messaging
বার্ধক্য = Old age
বার্নিশ = Varnish
বার্ষিক = Annually
বালতি = Bucket
বালি = Sand
বালিকা = Girl
বালিশ = Pillow
বালু = Sand
বাল্য = Childhood
বাল্যকাল = Childhood
বাল্যবিবাহ = Child marriage
বাষ্প = Steamy
বাষ্পীয় = Steamy
বাসন = Dishes
বাসনা = Desire
বাসস্থান = Residence
বাসা = Home
বাসাবাড়ি = House
বাসিন্দা = Resident
বাসী = Resident
বাস্তব = Real
বাস্তবতা = Reality
বাস্তববাদী = Realist
বাস্তবায়ন = Implementation
বাস্তবিক = Realistic
বাহক = Carrier
বাহন = Vehicle
বাহবা = Wow
বাহাদুরি = Bravery
বাহানা = Excuse
বাহার = Outside
বাহিনী = Forces
বাহির = Outside
বাহু = Arm
বাহুবন্ধন = Armband
বাহুল্য = Needless
বাহ্যিক = External
বিকর্ষণ = Repulsion
বিকল = Crippled
বিকলাঙ্গ = Disabled
বিকল্প = Alternative
বিকশিত = Developed
বিকার = Disorder
বিকারগ্রস্ত = Deranged
বিকাল = Afternoon
বিকাশিত = Developed
বিকিরণ = Radiation
বিকৃত = Distorted
বিকৃতি = Deformity
বিক্রয় = Sales
বিক্রি = Sale
বিক্রেতা = Seller
বিক্ষত = Upset
বিক্ষিপ্ত = Distracted
বিক্ষুব্ধ = Angry
বিক্ষেপ = Distraction
বিক্ষোভ = Demonstration
বিখ্যাত = Famous
বিগড়ানো = Screw up
বিগত = Past
বিগলিত = Melted
বিঘ্ন = Disruption
বিঘ্নিত = Interrupted
বিচক্ষণ = Discreet
বিচরণ = Wandering
বিচল = Upset
বিচলন = Distraction
বিচলিত = Upset
বিচার = Trial
বিচারক = Judge
বিচারশূন্য = Without judgment
বিচারসাপেক্ষ = Subject to judgment
বিচিত্র = Strange
বিচিত্রা = Different
বিচূর্ণ = Crushed
বিচ্ছিন্ন = Isolated
বিচ্ছিরি = Sloppy
বিচ্ছু = Scorpion
বিচ্ছেদ = Break up
বিচ্যুত = Deviate
বিচ্যুতি = Deviation
বিছানা = Bed
বিছুতি = Release
বিজড়িত = Tangled up
বিজয় = Victory
বিজয়ী = Winner
বিজলী = Electricity
বিজোড় = Odd
বিজ্ঞ = Wise
বিজ্ঞান = Science
বিজ্ঞানী = Scientist
বিজ্ঞাপন = Advertisement
বিড়বিড় = Murmur
বিড়ম্বনা = Irony
বিড়াল = Cat
বিড়ি = Cigar
বিতণ্ডা = Controversy
বিতরণ = Distribution
বিতর্ক = Controversy
বিতর্কিত = Controversial
বিতৃষ্ণা = Disgust
বিত্ত = Finance
বিদঘুটে = Freak
বিদায় = Bye
বিদায়ী = Farewell
বিদারক = Breaker
বিদীর্ণ = Torn apart
বিদেশ = Abroad
বিদেশী = Foreigner
বিদেহী = Departed
বিদ্বেষ = Hatred
বিদ্বেষী = Hater
বিদ্যমান = Exist
বিদ্যাপীঠ = School
বিদ্যার্জন = Education
বিদ্যালয় = School
বিদ্যাশূন্য = Uneducated
বিদ্রূপ = Irony
বিদ্রোহ = Rebellion
বিদ্রোহী = Rebel
বিধবা = Widow
বিধর্মী = Heathen
বিধস্ত = Devastated
বিধাতা = God
বিধান = Provisions
বিধি = Rules
বিধিনিষেধ = Restrictions
বিধিসম্মত = Lawful
বিধেয় = Due to
বিধ্বংসী = Devastating
বিনত = Submissive
বিনতি = Request
বিনম্র = Humble
বিনয় = Modesty
বিনয়ী = Polite
বিনা = Without
বিনাশ = Annihilation
বিনাশী = Destruction
বিনিদ্র
বিনিময় = Exchange
বিনিয়োগ = Investment
বিনীত = Humble
বিনোদন = Entertainment
বিনোদিত = Amused
বিন্দু = Point
বিন্দুমাত্র = At least
বিন্যাস = Layout
বিপক্ষ = Opponent
বিপজ্জনক = Dangerous
বিপথ = Astray
বিপদ = Danger
বিপন্ন = Endangered
বিপরীত = Opposite
বিপরীতার্থক = Opposite
বিপর্যয় = Disaster
বিপর্যস্ত = Upset
বিপাক = Metabolism
বিপ্লব = Revolution
বিপ্লবী = Revolutionary
বিফল = Failure
বিবরণ = Details
বিবর্জন = Exclusion
বিবর্ণ = Faded
বিবর্তন = Evolution
বিবর্ধন = Enlargement
বিবর্ধিত = Magnified
বিবস্ত্র = Naked
বিবাদ = Dispute
বিবাহ = Marriage
বিবাহিত = Married
বিবৃত = Stated
বিবেক = Conscience
বিবেকহীন = Senseless
বিবেচনা = Consideration
বিব্রত = Embarrassed
বিভক্ত = Divided
বিভব = Universe
বিভাগ = Department
বিভাজন = Division
বিভাজ্য = Divisible
বিভিন্ন = Different
বিভীষণ = Terrible
বিভ্রম = Illusion
বিভ্রাট = Outage
বিভ্রান্ত = Confused
বিমা = Insurance
বিমান = Airplane
বিমানবন্দর = Airport
বিমানবাহিনী = Air force
বিমূঢ় = Confused
বিমূর্ত = Abstract
বিমোচন = Absolution
বিমোহিত = Amused
বিম্ব = Image
বিয়োগ = Minus
বিয়োজন = Separation
বিরক্ত = Bored
বিরক্তি = Annoyance
বিরতি = Pause
বিরল = Rare
বিরাজ = Exist
বিরাজমান = Exist
বিরাট = Huge
বিরামহীন = Uninterrupted
বিরুদ্ধ = Against
বিরূপ = Opposite
বিরেচন = Solution
বিরোধ = Dispute
বিরোধিত = Conflicted
বিরোধিতা = Opposition
বিরোধী = Opposition
বিল = Bill
বিলক্ষণ = Procrastination
বিলম্ব = Delay
বিলম্বন = Procrastination
বিলাপ = Lamentation
বিলাস = Luxury
বিলীন = Disappear
বিলুপ্ত = Extinct
বিলোপ = Elimination
বিশ = Twenty
বিশারদ = Expert
বিশাল = Huge
বিশিষ্ট = Prominent
বিশুদ্ধ = Pure
বিশৃঙ্খল = Chaotic
বিশোধন = Refinement
বিশ্ব = World
বিশ্বকবি = World poet
বিশ্বকোষ = Encyclopedia
বিশ্বস্ত = Faithful
বিশ্বাস = Faith
বিশ্বাসঘাতক = Traitor
বিশ্রাম = Rest
বিশ্লিষ্ট = Complex
বিশ্লেষণ = Analysis
বিষ = Poison
বিষক্রিয়া = Poisoning
বিষধর = Poisonous
বিষবৃক্ষ = Poison ivy
বিষম = Odd
বিষমবাহু = Isosceles
বিষাক্ত = Poisonous
বিষাদ = Sadness
বিষুবীয় = Equatorial
বিষ্ঠা = Shit
বিসদৃশ = Unlike
বিসর্জন = Abandonment
বিস্তর = A lot
বিস্তারিত = Details
বিস্তীর্ণ = Vast
বিস্ফোরক = Explosive
বিস্ফোরণ = Explosion
বিস্বাদ = Dispute
বিস্ময় = Surprise
বিস্ময়কর = Amazing
বিস্ময়চিহ্ন = Exclamation mark
বিস্মিত = Amazed
বিহীন = Without
বিহ্বল = Bewildered
বীক্ষণ = View
বীক্ষিত = Experienced
বীজগণিত = Algebra
বীণা = Harp
বীমা = Insurance
বীর = Hero
বীরত্ব = Bravery
বীরপ্রসূ = Heroic mother
বীরাঙ্গনা = Heroism
বীর্য = Semen
বুক = Chest
বুকশেলফ = Bookshelf
বুট = Boots
বুড়া = Old
বুড়ি = Old lady
বুথ = Booth
বুদ্ধ = Buddha
বুদ্ধি = Intelligence
বুদ্ধিজীবী = Intellectual
বুদ্ধিনাশ = Brain dead
বুদ্ধিমতী = Intelligent
বুদ্ধিমত্তা = Intelligence
বুদ্বুদ = Bubble
বুনট = Knit
বুনন = Knitting
বুনা = Knit
বুনো = Wild
বৃক্ক = Kidney
বৃক্ষ = Tree
বৃত্ত = Circle
বৃত্তাকার = Circular
বৃত্তান্ত = Resume
বৃত্তি = Scholarship
বৃথা = In vain
বৃদ্ধ = Old man
বৃদ্ধা = Old woman
বৃদ্ধাঙ্গুলি = Thumb
বৃদ্ধি = Growth
বৃন্ত = Stalk
বৃশ্চিক = Scorpio
বৃষ = Taurus
বৃষ্টি = Rain
বৃহত্তম = Largest
বৃহত্তর = Greater
বৃহদন্ত্র = Large intestine
বেঈমানি = Dishonesty
বেঈমানী = Unscrupulous
বেকসুর = Innocent
বেকায়দা = Useless
বেকার = Unemployment
বেকারী = Bakery
বেকুব = Stupid
বেগ = Velocity
বেগতিক = Kinetic
বেগম = Begum
বেগুন = Eggplant
বেগুনী = Purple
বেচা = Sold
বেচারা = Poor
বেজোড় = Odd
বেঠিক = Wrong
বেড়া = Fence
বেড়ি = Shackles
বেণী = Pigtails
বেত = Cane
বেতনগ্রাহী = Salaried
বেতার = Wireless
বেতারযন্ত্র = Radio equipment
বেতাল = Idle
বেত্রাঘাত = Flogging
বেদনা = Pain
বেদী = Altar
বেনাম = Anonymous
বেনামী = Anonymous
বেপরোয়া = Careless
বেমানান = Incompatible
বেয়াড়া = Crazy
বেয়ারিং = Bearing
বের = Get out
বেল = Bell
বেলচা = Shovel
বেলন = Roller
বেলা = In the morning
বেশ = Quite
বেশী = More
বেশ্যা = Whore
বেষ্টন = Circle
বেষ্টনী = Fence
বেষ্টিত = Surrounded by
বেসরকারী = Private
বেহায়া = Naughty
বেহাল = Unwell
বেহিসাবী = Unaccountable
বেহুঁশ = Unconscious
বৈচিত্র = Variety
বৈঠক = Meeting
বৈঠকখানা = Meeting room
বৈদেশিক = Foreign
বৈদ্য = Medicine
বৈদ্যুতিক = Electric
বৈধ = Valid
বৈধতা = Validity
বৈভব = Splendor
বৈরাগী = Apathetic
বৈরী = Hostile
বৈশিষ্ট্য = Characteristics
বোকা = Stupid
বোকামি = Foolishness
বোঝা = Understand
বোঝাপড়া = Understanding
বোঝাবুঝি = Understanding
বোট = Boat
বোতল = Bottle
বোতাম = Button
বোদ্ধা
বোধ = Feeling
বোধগম্য = Understandable
বোধশক্তি = Intellect
বোধহয় = Perhaps
বোধোদয় = Understandably
বোনা = Woven
বোবা = Dumb
বোম = Bomb
বোম্বাই = Bombay
বোরকা = Burqa
বোর্ড = Board
বোলতা = Speechless
বৌ = Wife
বৌঠান = Yard
বৌদি = Daughter-in-law
বৌদ্ধ = Buddhist
বৌদ্ধধর্ম = Buddhism
বৌভাত = Son-in-law
ব্যক্ত = Expressed
ব্যক্তি = Person
ব্যক্তিগত = Personal
ব্যক্তিত্ব = Personality
ব্যগ্র = Busy
ব্যঙ্গ = Sarcasm
ব্যঞ্জনবর্ণ = Consonant
ব্যতিক্রম = Exception
ব্যতিব্যস্ত = Distracted
ব্যতিহার = Absence
ব্যতীত = Except
ব্যথা = Pain
ব্যথিত = Distressed
ব্যবচ্ছেদ = Dissection
ব্যবধান = Gap
ব্যবসা = Business
ব্যবসায়ী = Businessman
ব্যবস্থা = System
ব্যবস্থাপক = Manager
ব্যবহার = Use
ব্যবহারিক = Practical
ব্যবহার্য = Used
ব্যবহৃত = Used
ব্যভিচার = Adultery
ব্যভিচারিণী = Adulteress
ব্যভিচারী = Adulterer
ব্যয় = Expenditure
ব্যয়বহুল = Expensive
ব্যয়বাহুল্য = Costless
ব্যয়সাধ্য = Cost effective
ব্যর্থ = Failed
ব্যর্থতা = Failure
ব্যস্ত = Busy
ব্যস্ততা = Preoccupation
ব্যাংক = Bank
ব্যাকরণ = Grammar
ব্যাকুল = Bewildered
ব্যাখ্যা = Explanation
ব্যাগ = Bag
ব্যাঘাত = Disruption
ব্যাঙ = Frog
ব্যাটারি = Battery
ব্যাডমিন্টন = Badminton
ব্যাধি = Disease
ব্যাধিগ্রস্ত = Diseased
ব্যাধিত = Ill
ব্যান্ড = Band
ব্যান্ডেজ = Bandage
ব্যাপক = Extensive
ব্যাপার = Matter
ব্যাপারী = Dealer
ব্যাপী = Throughout
ব্যাপ্তি = Scope
ব্যাবসা = Business
ব্যাবহারিক = Practical
ব্যায়াম = Exercise
ব্যায়ামচর্চা = Exercise
ব্যায়ামাগার = Gym
ব্যারিস্টার = Barrister
ব্যাস = Diameter
ব্যাসার্ধ = Radius
ব্যূহ = Array
ব্রণ = Acne
ব্রত = Vow
ব্রহ্ম = Brahman
ব্রাহ্মণ = Brahmin
ব্রাহ্মী = Brahmi
ব্রিজ = Bridge
ব্রিটিশ = British
ব্র্যাকেট = Bracket
ব্লাউজ = Blouse
ব্ল্যাকবোর্ড = Blackboard
ভ = The twenty fourth consonant of the Bengali alphabet
ভক্ত = Devotee
ভক্তি = Devotion
ভক্ষক = Eater
ভক্ষণ = Eating
ভক্ষিত = Eaten up
ভগ্ন = Broken
ভগ্নদূত = Messenger
ভগ্নস্তূপ = Broken pile
ভগ্নাংশ = Fraction
ভগ্নাবশেষ = Debris
ভগ্নীপতি = Sister-in-law
ভঙ্গ = Broken
ভঙ্গি = Pose
ভঙ্গিমা = Pose
ভঙ্গী = Pose
ভড়্‌কানো = Provoke
ভণিতা = Provoke
ভণ্ড = Hypocrite
ভণ্ডামি = Hypocrisy
ভদ্র = Polite
ভদ্রতা = Gentleness
ভদ্রমহোদয় = Sir
ভদ্রলোক = Gentleman
ভনভন = Pretending
ভবঘুরে = Wanderer
ভবতারিণী
ভবন = Building
ভবিতব্য = Prophecy
ভবিষ্য = Future
ভয় = Fear
ভয়ঙ্কর = Terrible
ভয়ানক = Terrible
ভয়াবহ = Horrible
ভয়ার্ত = Scary
ভর = Mass
ভরণ = Filling
ভরণপোষণ = Sustenance
ভরতি = Intake
ভরপুর = Full of
ভরপেট = Full stomach
ভরসা = Trust
ভরা = Full of
ভর্তুকি = Subsidy
ভলান্টিয়ার = Volunteer
ভল্লুক = Bear
ভস্ম = Ashes
ভাঁজ = Fold
ভাঁড় = Clown
ভাঁড়ামি = Fake
ভাই = Brother
ভাইঝি = Niece
ভাইপো = Nephew
ভাইভাই = Siblings
ভাইস্‌-চ্যান্‌সেলার = Vice-Chancellor
ভাগ = Share
ভাগনা = Nephew
ভাগা = Escape
ভাগাড় = Waste
ভাগিনী = Niece
ভাগী = Sharer
ভাগীদার = Sharer
ভাগ্নী = Niece
ভাগ্য = Fate
ভাগ্যক্রমে = Luckily
ভাগ্যগণনা = Fortune telling
ভাগ্যগুণে = Luckily
ভাগ্যচক্র = Fateful
ভাগ্যদেবতা = God of fortune
ভাগ্যবতী = Lucky
ভাগ্যবান = Lucky
ভাগ্যিস = Good luck
ভাঙচুর = Vandalism
ভাঙ্গা = Broken
ভাজি = Fried
ভাটি = Furnace
ভাড়া = Rent
ভাড়াটিয়া = Tenant
ভাড়াটে = Tenant
ভাড়াবাড়ি = Rental house
ভাণ্ডার = Store
ভাত = Rice
ভাতকাপড় = Rice cloth
ভাতা = Allowance
ভাতিজা = Nephew
ভাদ্র = Polite
ভান = Pretend
ভাপ = Steam
ভাব = Thought
ভাবগত = Emotional
ভাবনা = Thoughts
ভাবভঙ্গি = Attitude
ভাবমূর্তি = Image
ভাবা = To think
ভাবি = Think
ভার = Load
ভারবাহক = Bearer
ভারবাহী = Burdensome
ভারসাম্য = Balance
ভারা = Scaffolding
ভারাক্রান্ত = Burdened
ভারী = Heavy
ভালুক = Bear
ভালো = Good
ভালোবাসা = Love
ভালোমন্দ = Good and bad
ভালোমানুষ = Good man
ভাষণ = Speech
ভাষা = Language
ভাষাজ্ঞান = Linguistics
ভাষাতত্ত্ব = Linguistics
ভাষাতাত্ত্বিক = Linguist
ভাষী = Speaker
ভাষ্য = Commentary
ভাসা = Float
ভাস্কর্য = Sculpture
ভিক্ষা = Alms
ভিখারী = Beggar
ভিজা = Wet
ভিটেমাটি = Soil
ভিড় = Crowd
ভিতর = Inside
ভিতু = Scared
ভিত্তি = Base / foundation
ভিত্তিক = Based on
ভিত্তিপ্রস্তর = Foundation stone
ভিত্তিহীন = Baseless
ভিনদেশ = A foreign country
ভিন্ন = Different
ভিন্নতা = Difference
ভিমরুল = Vimrul
ভিসা = Visa
ভীড় = Crowd
ভীত = Scared
ভীতু = Timid
ভীরু = Timid
ভীষণ = Very
ভুক্তভোগী = Victim
ভুজ = Elbow
ভুতুড়ে = Haunted
ভুবন = World
ভুবনবিখ্যাত = World famous
ভুয়া = Fake
ভুরু = Eyebrows
ভুরূ = Brow
ভুল = Wrong
ভুলা = Forget
ভূকম্প = Earthquake
ভূকম্পন = Earthquake
ভূখণ্ড = Terrain
ভূগর্ভ = Underground
ভূগর্ভস্থ = Underground
ভূগোল = Geography
ভূত = Ghost
ভূতপূর্ব = Past
ভূতপ্রেত = Haunted
ভূপৃষ্ঠ = Surface
ভূমধ্যরেখা = Equator
ভূমি = Land
ভূমিকম্প = Earthquake
ভূমিকা = Introduction
ভূমিষ্ঠ = Earth
ভূরিভোজন = Feast
ভূষা = Cloth
ভূষিত = Awarded
ভূসম্পত্তি = Real estate
ভূস্বর্গ = Heaven
ভৃত = Ghost
ভেজা = Wet
ভেজানো = Soak
ভেড়া = Sheep
ভেদ = Difference
ভেদাভেদ = Difference
ভেদ্য = Penetrable
ভেলা = Raft
ভেষজ = Herbs
ভোক্তা = Consumer
ভোগ = Enjoying
ভোগা = Suffer
ভোগী = Consumer
ভোজ = Banquet
ভোজন = Food
ভোজনবিলাসী = Gourmet
ভোজনাগার = Dining room
ভোজ্য = Edible
ভোট = Vote
ভোটার = Voter
ভোর = Dawn
ভোরবেলা = In the morning
ভোলা = Gullible
ভৌগোলিক = Geographical
ভৌত = Physical
ভৌতিক = Ghostly
ভ্রম = Illusion
ভ্রমণ = Traveling
ভ্রমণবৃত্তান্ত = Travelogue
ভ্রমর = Illusion
ভ্রষ্ট = Corrupted
ভ্রাতা = Brother
ভ্রাতৃ = Brother
ভ্রাতৃত্ব = Brotherhood
ভ্রাম্যমাণ = Mobile
ভ্রূকুটি = Frown
ভ্রূক্ষেপ = Overview
ভ্রূণ = Fetus
ম = The twenty fifth consonant of the Bengali alphabet
মই = Ladder
মওকা = Opportunity
মকদ্দমা = Litigation
মক্কেল = Client
মক্তব = Mosque
মক্ষী = Fly
মখমল = Velvet
মগ = Mug
মগজ = Brain
মগ্ন = Busy
মঙ্গল = Mars
মঙ্গলকামনা = Good luck
মচকান = Twist
মচকানো = Twisted
মজা = Fun
মজুদ = In stock
মজুদদার = Hoarder
মজুর = Laborer
মজুরি = Wages]
মঞ্জিল = Floor
মঞ্জুর = Granted
মটর = Pea
মঠ = Monastery
মঠধারী = Abbot
মড়মড় = Stutter
মণি = Gem
মণিমাণিক্য = Gem
মণ্ডপ = Pavilion
মত = Like
মতবাদ = Doctrine
মতবিরোধ = Disagreement
মতভেদ = Difference of opinion
মতান্তর = Conversion
মতামত = Opinion
মতিগতি = Opinion
মত্ত = Drunk
মদ = Alcohol
মদখোর = Alcoholic
মদত = Support
মদ্দা = Drink
মদ্য = Alcohol
মদ্যপ = Alcoholic
মদ্যপায়ী = Alcoholic
মধু = Honey
মধ্য = Middle
মধ্যচ্ছদা = Diaphragm
মধ্যপন্থা = Middle way
মধ্যবিত্ত = Middle class
মধ্যবিন্দু = Mid point
মধ্যমা = Median
মধ্যস্থ = In the middle
মধ্যস্থতা = Mediation
মধ্যাহ্ন = Midday
মন = Mind
মনগড়া = Made up
মননশীল = Thoughtful
মনস্কামনা = Desire
মনীষী = Thinker
মনুষ্য = Man
মনুষ্যত্ব = Humanity
মনোনিবেশ = Concentration
মনোবিজ্ঞান = Psychology
মনোযোগ = Attention
মনোযোগী = Attentive
মনোরঞ্জন = Entertainment
মনোরম = Lovely
মনোহর = Charming
মন্তব্য = Comment
মন্ত্র = Mantra
মন্ত্রণা = Ministry
মন্ত্রমুগ্ধ = Enchanted
মন্ত্রসাধক = Magician
মন্ত্রিত্ব = Ministry of
মন্ত্রী = Minister
মন্থন = Churn
মন্থর = Slow
মন্দ = Evil
মন্দন = Deceleration
মন্দা = Recession
মন্দির = Temple
মমতা = Affection
ময়দা = Flour
ময়দান = Field
ময়না = Myna
ময়নাতদন্ত = Autopsy
ময়রা = Confectioner
ময়লা = Dirt
ময়ূর = Peacock
মরচে = Rust
মরণ = Death
মরদ = Man
মরা = Die
মরীচিকা = Mirage
মরু = Desert
মরুভূমি = Desert
মর্গ = Morgue
মর্ত = Earth
মর্তমান = Mortal
মর্ত্য = Mortal
মর্ম = Meaning
মর্মঘাতী = Fatal
মর্মর = Murmur
মর্মাহত = Shocked
মর্যাদা = Dignity
মলাট = Bookbinding
মলিন = Dirty
মল্লযুদ্ধ = Wrestling
মল্লযোদ্ধা = Wrestler
মশলা = Spices
মশা = Mosquito
মশাল = Torch
মসজিদ = Mosque
মসলিন = Muslin
মসী = Ink
মসুর = Lentils
মসৃণ = Smooth
মস্তক = Head
মস্তান = Hooligan
মস্তিষ্ক = Brain
মহাকবি = Epic poet
মহাকর্ষ = Gravity
মহাকাশ = Space
মহাকাশচারী = Astronaut
মহাকাশযান = Spaceship
মহানগর = Metropolis
মহানুভব = Generous
মহারাজ = Your Majesty
মহারাণী = Queen
মহাশয় = Monsieur
মহাশূন্য = Space
মহাশ্মশান = Crematorium
মহাসমুদ্র = The great ocean
মহিমান্বিত = Glorious
মহিলা = Woman
মা = Mother
মাংস = Meat
মাংসপিণ্ড = Lump of meat
মাংসপেশী = Muscles
মাংসল = Meaty
মাংসাশী = Carnivore
মাইক = Mike
মাকড়সা = Spider
মাখন = Butter
মাগুরমাছ = Catfish
মাচান = Loft
মাছ = Fish
মাছরাঙা = Kingfisher
মাছি = Fly
মাজা = Scrub
মাজার = Shrine
মাঝি = Sailor
মাঝে = Between
মাটি = Soil
মাঠ = Field
মাড়া = Step on
মাণিক = Ruby
মাতুল = Excited
মাতৃ = Mother
মাতৃক্রোড় = Maternal blood
মাতৃভক্তি = Matriarchy
মাতৃস্নেহ = Mother's love
মাতৃহারা = Motherless
মাত্র = Only
মাত্রা = Dimension
মাত্রাতিরিক্ত = Excessive
মাথা = Head
মাদক = Drugs
মাদকদ্রব্য = Drug
মাদুর = Mat
মাধ্যমিক = Secondary
মানচিত্র = Map
মাননীয় = Respectable
মানপত্র = Standard
মানবজাতি = Mankind
মানবিক = Humane
মানবিকতা = Humanity
মানানসই = Suit
মান্য = Value
মাপ = Size
মাপকাঠি = Criteria
মাপা = Measured
মামী = Aunty
মায়া = Illusion
মারা = Die
মারাত্মক = Deadly
মার্জনা = Forgiveness
মার্জনীয় = Elegant
মালিক = Owner
মালিকানা = Ownership
মালিশ = Massage
মালী = Gardener
মাল্য = মাল্য
মাষ্টার = Master
মাষ্টারমশাই = Master
মাহাত্ম্য = Greatness
মিউজিয়াম = Museum
মিঠাই = Sweet
মিতভাষী = Eloquent
মিথ্যাবাদী = Liar
মিথ্যুক = Liar
মিনতি = Begging
মিনার = Tower
মিশর = Egypt
মিশ্র = Mixed
মিশ্রণ = Mixture
মিশ্রিত = Mixed up
মিষ্ট = Sweet
মিষ্টতা = Sweetness
মিষ্টভাষী = Soft spoken
মিষ্টান্ন = Sweets
মিষ্টি = Sweet
মুকুল = Bud
মুক্ত = Free
মুক্তহস্ত = Free hand
মুক্তা = Pearl
মুক্তাঙ্গন = Open door
মুক্তি = Liberation
মুক্তিযোদ্ধা = Freedom fighter
মুখ = Face
মুখচ্ছটা = Face
মুখচ্ছবি = Face
মুখফোড় = Mouth
মুখভঙ্গি = Facial expressions
মুখর = Face
মুখোমুখি = Face to face
মুখোশ = Mask
মুখ্য = Main
মুগ্ধ = Fascinated
মুছা = Wipe
মুঠো = V
মুদ্রণ = Printing
মুদ্রা = Currency
মুদ্রাস্ফীতি = Inflation
মুরগী = Chicken
মুষলধারা = Torrential rain
মুষ্টিবদ্ধ = Clenched fist
মুষ্টিমেয় = Handful
মুসলমান = Muslim
মুসাফির = Passenger
মূর্খ = Stupid
মূর্তি = Statue
মূলনীতি = Principles
মূল্যায়ন = Assessment
মৃত = Dead
মৃদু = Soft
মেঘ = Cloud
মেঘগর্জন = Thunder
মেধাবী = Genius
মেম্বার = Member
মেয়াদ = Duration
মেয়াদী = Term
মেয়ে = Girl
মেরামত = Repair
মেরু = Polar
মেরুদণ্ড = Spine
মেরুদণ্ডী = Vertebrate
মেলা = Fair
মোরগ = Rooster
মোরব্বা = Marmalade
মোহ = Infatuation
মোহগ্রস্ত = Infatuated
মৌখিক = Oral
মৌচাক = Beehive
মৌন = Silence
মৌনব্রত = Bee
মৌমাছি = Bee
মৌল = Element
মৌলবী = Cleric
মৌলিক = Basic
ম্যাগাজিন = Magazine
ম্যাচ = Match
ম্যাজিস্ট্রেট = Magistrate
ম্যালেরিয়া = Malaria
য = The twenty sixth consonant of the Bengali alphabet
যকৃত্‌ = Liver
যক্ষ্মা = Tuberculosis
যখন = When
যখন-তখন = Whenever
যত = As much
যতটা = As much as
যতটুকু = As much as
যত্ন = Care
যথা = Namely
যথাযথ = Proper
যথারীতি = As usual
যথার্থ = Correct
যথেষ্ট = Enough
যদি = If
যন্ত্র = Machine
যন্ত্রণা = Pain
যমজ = Twins
যাত্রা = Journey
যাদু = Magic
যাদুকর = Magician
যানজট = Traffic jam
যানবাহন = Vehicle
যান্ত্রিক = Mechanical
যুক্তাক্ষর = Letter
যুক্তি = Logic
যুগ = Era
যুগল = Couple
যুদ্ধ = War
যুবক = Young man
যোগ = Add
যোগফল = Sum
যোগব্যায়াম = Yoga
যোগসূত্র = Link
যোগ্য = Qualified
যোগ্যতা = Qualification
যোজক = Adder
যোদ্ধা = Warrior
যৌতুক = Dowry
যৌথ = Joint
যৌন = Sex
যৌবন = Youth
যৌবনকাল = Youth
য় = A letter of the Bengali alphabet
র = The twenty seventh consonant of the Bengali alphabet
রং = Color
রওনা = Depart
রকম = Sort of
রক্ত = Blood
রক্তক্ষয় = Blood loss
রক্তচক্ষু = Bloodshot eyes
রক্তপরীক্ষা = Blood test
রক্তপাত = Bleeding
রক্তপিণ্ড = Blood clot
রক্তপিপাসা = Blood-lust
রক্তবর্ণ = Crimson
রক্তলোচন = Bleeding
রক্তস্রাব = Hemorrhage
রক্তস্রোত = Blood flow
রক্তহীনতা = Anemia
রক্তাক্ত = Bloody
রক্তাধিক্য = Plethora
রক্তিম = Aflame
রক্তিমা = Ruby
রক্ষক = Protector
রক্ষণ = Defense
রক্ষা = Save
রক্ষাকর্তা = Protector
রগচটা = Bad-tempered
রগড়ানো = Rub
রঙ = Color
রঙিন = Colorful
রঙিলা = Colorful
রঙ্গ = Hue
রঙ্গন = Paint
রঙ্গরসিকতা = Humor
রঙ্গশালা = Theater
রচনা = Composition
রচয়িতা = Author
রচিত = Composed
রজকী = Laundress
রজত = Silver
রজতজয়ন্তী = Silver Jubilee
রজনী = Night
রজনীগন্ধা = Tuberose
রজ্জু = Cord
রঞ্জক = Dye
রঞ্জন = Dyeing
রঞ্জনরশ্মি = Rontgen ray
রটা = Happen
রণ = Battle
রণকৌশল = Tactics
রণক্ষেত্র = Battlefield
রত্ন = Gem
রত্নখচিত = Bejeweled
রত্নগর্ভ = Jeweled
রথ = Chariot
রদ = Canceled
রদবদল = Reshuffle
রন্ধন = Cooking
রন্ধনশালা = Kitchen
রন্ধ্র = Hole
রপ্তানী = Export
রফা = Compromise
রব = Lord
রবি = Sun
রমজান = Ramadan
রমণী = Woman
রম্য = Delightful
রশ্মি = Ray
রস = Juice
রসহীন = Sapless
রসুন = Garlic
রহস্য = Mystery
রহস্যপূর্ণ = Mysterious
রাঁধা = Cook
রাইফেল = Rifle
রাক্ষস = Demon
রাখাল = Shepherd
রাগ = Anger
রাগা = Angry
রাগান্বিত = Angry
রাঙা = Flushed
রাজকন্যা = Princess
রাজকীয় = Royal
রাজকোষ = Treasury
রাজতন্ত্র = Monarchy
রাজত্ব = Reign
রাজদণ্ড = Scepter
রাজদম্পতী = Royal couple
রাজদরবার = Royal court
রাজদ্রোহ = Treason
রাজধানী = Capital
রাজনীতি = Politics
রাজপথ = Highway 
রাজপুত্র = Prince
রাজপ্রাসাদ = Palace
রাজবংশ = Dynasty
রাজভক্ত = Royal devotee
রাজভৃত্য = Royal servant
রাজভোগ = Royal enjoyment
রাজমিস্ত্রি = Mason
রাজমুকুট = Crown
রাজসভা = Court
রাজসেবা = Royal service
রাজস্ব = Revenue
রাজা = King
রাজাধিরাজ = Lord
রাজী = Agree
রাজ্ঞী = Queen
রাজ্য = State
রাজ্যচ্যুত = Ousted
রাজ্যপাল = Governor
রাজ্যভার = Governorship
রাজ্যশাসন = Rule
রাজ্যহারা = Stateless
রাণী = Queen
রাত = Night
রাতদিন = Day and night
রাতভর = All night
রাতারাতি = Overnight
রাত্রি = Night
রান্না = Cooking
রান্নাঘর = Kitchen
রামধনু = Rainbow
রায় = Judgment
রাশি = Sign
রাশিচক্র = Zodiac sign
রাষ্ট্র = State
রাষ্ট্রদূত = Ambassador
রাষ্ট্রনায়ক = Statesman
রাষ্ট্রনীতি = Politics
রাষ্ট্রপতি = President
রাষ্ট্রীয় = National
রাস্তা = Road
রাস্তাঘাট = Streets
রিং = Ring
রিকশা = Rickshaw
রিকশাওয়ালা = Rickshaw puller
রিক্ত = Empty
রিভলবার = Revolver
রীতি = Custom
রীতিনীতি = Customs
রীতিমত = As usual
রুক্ষ = Rough
রুক্ষতা = Roughness
রুক্ষমূর্তি = Rough shape
রুগী = Patient
রুচি = Taste
রুচিসম্মত = Tasteful
রুটিন = Routine
রুদ্ধ = Blocked
রুদ্ধশ্বাস = Shortness of breath
রুপা = Silver
রুপালী = Silver
রুমাল = Handkerchief
রুহিতন = Diamond
রেখা = Line
রেখাংশ = Length
রেচন = Excretion
রেজিস্ট্রি = Registry
রেডিও = Radio
রেণু = Pollen
রেফারী = Referee
রেল = Rail
রেলগাড়ি = Train
রেললাইন = Railway line
রেশমি = Silk
রোগ = Disease
রোগগ্রস্ত = Sick
রোগজীবাণু = Bacterium
রোগজীর্ণ = Diseased
রোগদমন = Disease control
রোগনিবন্ধন = Diagnosis
রোগনির্ণয় = Diagnosis
রোগপরীক্ষা = Medical examination
রোগমুক্তি = Cure
রোগা = Skinny
রোজ = Daily
রোজগার = Earnings
রোজা = Fasting
রোদ = Sunshine
রোধ = Prevention
রোপণ = Planting
রোপা = Seedling
রোমান = Roman
রৌদ্র = Sunshine
রৌদ্রস্নান = Sunbathing
রৌদ্রোজ্জ্বল = Sunny
রৌপ্য = Silver
রৌপ্যমুদ্রা = Silver coin
ল = The twenty eighth consonant of the Bengali alphabet
লকড়ি = Stick
লকেট = Locket
লক্ষণ = Symptoms
লক্ষণীয় = Noticeable
লক্ষপতি = Millionaire
লক্ষ্য = Aim
লক্ষ্যচ্যুত = Off target
লক্ষ্যভেদ = Target difference
লক্ষ্যহীন = Aimless
লঘু = Little
লঘুত্ব = Lightness
লঙ্কা = Chili
লজ্জা = Shame
লজ্জাবতী = Shy
লজ্জিত = Ashamed
লটারি = Lottery
লণ্ঠন = Lantern
লবঙ্গ = Cloves
লবণ = Salt
লব্ধ = Gain
লভ্য = Available
লভ্যাংশ = Dividend
লম্পট = Lustful
লম্ফ = Leap
লম্বা = Long
ললাট = Forehead
লাইন = Line
লাইব্রেরি = Library
লাইসেন্স = License
লাউ = Gourd
লাকড়ি = Wood
লাগামছাড়া = Unbridled
লাঙ্গল = Plow
লাজ = Shame
লাজলজ্জা = Shame
লাজুক = Shy
লাঞ্ছনা = Insult
লাঞ্ছিত = Humiliated
লাটীম = Top
লাঠি = Stick
লাঠিয়াল = Stick
লাথি = Kick
লাফ = Jump
লাবণ = Salt
লাবণ্য = Grace
লাভ = Profit
লাভজনক = Profitable
লাল = Red
লালচে = Reddish
লালসা = Lust
লালা = Saliva
লালায়িত = Flushed
লাশ = Dead body
লিখা = Write
লিঙ্গ = Gender
লিটার = Liter
লিপইয়ার = Leap year
লিপস্টিক = Lipstick
লিপি = Script
লিপিকর = Scribe
লিপিবদ্ধ = Written down
লিপ্ত = Engaged
লিপ্সা = Absence
লিভার = Liver
লীগ = League
লীলাভূমি = Greenery
লুকোচুরি = Hide and seek
লুটোপুটি = Loot
লুঠতরাজ = Robbery
লুণ্ঠন = Spoil
লুপ্ত = Lost
লুপ্তপ্রায় = Almost extinct
লেখা = Write
লেজ = Tail
লেট = Late
লেনদেন = Transaction
লেপ = Coating
লেবু = Lemon
লেবেল = Label
লেশ = Jot
লৈখিক = Written
লোক = People
লোকগাথা = Folklore
লোকচক্ষু = People's eye
লোকচরিত্র = Folk character
লোকজন = People
লোচন = Eye
লোভ = Greed
লোভনীয় = Alluring
লোভী = Greedy
লোম = Hair
লোমকূপ = Follicle
লোমহর্ষক = Gruesome
লোহা = Iron
লৌহ = Iron
ল্যাংড়া = Limping
ল্যাম্প = Lamp
শ = The thirtieth consonant of the Bengali alphabet
শক = Shock
শকুন = Vulture
শক্ত = Tough
শক্তি = Strength
শক্তিশালী = Strong
শক্তিহীন = Powerless
শখ = Hobby
শঙ্কিত = Alarmed
শঙ্খ = Conch shell
শঙ্খধ্বনি = Conch sound
শঠ = Hard
শত = Hundred
শতচ্ছদ = Centenary
শতদল = Hundreds of
শতধার = Hundred
শতাব্দী = Century
শত্রু = Enemy
শত্রুঘ্ন = Enemy
শত্রুজয়ী = Enemy conqueror
শত্রুতা = Enmity
শত্রুমিত্র = Enemy
শনশন = Session
শনাক্ত = Identified
শপথ = Oath
শপ্ত = Sworn
শব = Corpse
শবদহন = Cremation
শবদেহ = Corpse
শব্দ = Sound
শব্দকোষ = Glossary
শব্দতরঙ্গ = Sound waves
শব্দবিন্যাস = Syntax
শব্দভেদী = Speechless
শব্দাতীত = Wordless
শয্যা = Bed
শয্যাগত = Bedding
শয্যাশায়ী = Bedridden
শয়তানি = Satanic
শয়ন = Bed
শয়নকক্ষ = Bedroom
শয়নকাল = Bedtime
শয়িত = Lie down
শরক্ষেপণ = Summary
শরণার্থী = Refugee
শরবত = Syrup
শরম = Shame
শরীক = Partner
শরীর = Body
শর্করা = Sugar
শর্তভঙ্গ = Breach of condition
শর্তসাপেক্ষ = Conditional
শলাপরামর্শ = Disciplinary advice
শল্যচিকিত্‌সা = Surgery
শল্যোদ্ধার = Cure
শসা = Cucumber
শস্ত্র = Weapon
শস্য = Grain
শস্যক্ষেত্র = Crop field
শহর = City
শহরতলী = Suburbs
শহীদ = Martyr
শাঁখ = Conch shell
শাক = Vegetables
শাকসবজি = Vegetables
শান্ত = Calm down
শান্তশিষ্ট = Calm
শান্তি = Peace
শান্তিরক্ষা = Peacekeeping
শাপ = Curse
শাপমোচন = Curse
শাবক = Cub
শাবাশ = Well done
শায়িত = Lying down
শায়েস্তা = Discipline
শারদ = Autumn
শারদীয় = Autumnal
শালিক = Indian myna
শালী = Decent
শালীনতা = Decency
শাশুড়ী = Mother in law
শাশ্বত = Eternal
শাসনকর্তা = Ruler
শাসনতন্ত্র = Regime
শাস্ত্র = Scripture
শিং = Horn
শিকড় = Roots
শিকল = Chain
শিকার = Victim
শিকারী = Hunter
শিক্ষক = Teacher
শিক্ষণীয় = Instructive
শিক্ষা = Education
শিক্ষাগুরু = Teacher
শিক্ষামন্ত্রী = Minister of Education
শিক্ষিত = Educated
শিগ্‌গির = Soon
শিঙা = Horn
শিঙা = Trumpet
শিথিল = Relax
শিব = Shiva
শিবালয় = Shiva temple
শিবির = Camp
শিম = Bean
শির = Head
শিরশ্ছেদ = Beheading
শিরা = Veins
শিলালিপি = Inscription
শিল্প = Industry
শিল্পমন্ত্রী = Industries Minister
শিশির = Dew
শিশু = Child
শিষ = Disciple
শিষ্ট = Polite
শিষ্য = Disciple
শিহরণ = Tingling
শীঘ্র = Soon
শীত = Winter
শীতল = Cold
শীতাতপ = Air conditioning
শীতাতপনিয়ন্ত্রক = Air conditioner
শীতার্ত = Cold
শীর্ণ = Thin
শুঁয়োপোকা = Caterpillar
শুচি = Clean
শুচিবায়ু = Fresh air
শুট্‌কি = Dry
শুদ্ধ = Pure
শুদ্ধচিত্ত = Pure heart
শুদ্ধতা = Purity
শুদ্ধি = Purification
শুভ = Happy
শুভঙ্কর = Good luck 
শুভ্র = White
শুভ্রতা = Whiteness
শুয়োর = Pig
শুশ্রূষা = Nursing
শূন্য = Zero
শূন্যতা = Emptiness
শূলবিদ্ধ = Pierced
শৃগাল = Fox
শৃঙ্খল = Chain
শৃঙ্খলাবদ্ধ = Orderly
শৃঙ্গ = Horn
শৈত্য = Cold
শৈত্যপ্রবাহ = Cold flow
শৈবাল = Algae
শোক = Mourning
শোকগ্রস্ত = Bereaved
শোভিত = Adorned
শোরগোল = Noise
শোষণ = Exploitation
শৌখিন = Fond of
শৌচ = Defecate
শৌচাগার = Toilet
শ্বশুর = Father in law
শ্বশুরবংশ = In-laws
শ্বাস = Breath
শ্বাসক্রিয়া = Respiration
শ্বাসপ্রশ্বাস = Breathing
শ্বাসরোগ = Respiratory disease
শ্বাসরোধ = Suffocation
শ্বেত = White
শ্মশান = Crematorium
শ্যামলা = Brunette
শ্রবণ = Hearing
শ্রবণগোচর = Audible
শ্রবণীয় = Audible
শ্রম = Labor
শ্রমজীবী = Laborer
শ্রাব্য = Audible
শ্রুতি = Hearing
শ্রেণী = Class
শ্রেণীবিন্যাস = Taxonomy
শ্রেণীভুক্ত = Classified
শ্রেষ্ঠ = Best
ষ = The thirty first consonant of the Bengali alphabet
ষড়যন্ত্র = Conspiracy
ষড় = Six
ষড়্‌ঋতু = Season
ষত্ব = Ability
ষত্ববিধান = Constitution
ষষ্টি = Six
ষষ্ঠী = Sixth
ষাঁড় = Bull
ষাণ্মাসিক = Quarterly
ষোড়শ = Sixteenth
ষোলোকলা = Sixteen
স = The thirty second consonant of the Bengali alphabet
সংক্রান্ত = Regarding
সংক্ষিপ্ত = Condensed
সংখ্যা = Number
সংগ্রহ = Collection
সংগ্রাম = Struggle
সংঘর্ষ = Collision
সংজ্ঞা = Name
সংজ্ঞার্থ = Definition
সংবরণ = Restraint
সংবাদ = News
সংবাদপত্র = Newspaper
সংবিগ্ন = Worried
সংবেদ = Sensation
সংযত = Self controlled
সংযম = Restraint
সংযোগ = Connection
সংরক্ষক = Guardian
সংরক্ষিত = Protected
সংরুদ্ধ = Agitated
সংলাপ = Dialogue
সংশয় = Doubt
সংশুদ্ধ = Pure
সংসদ = Assembly
সংসর্গ = Contact
সংস্করণ = Edition
সংস্কর্তা = Reformer
সংস্কৃত = Purified
সংস্কৃতি = Culture
সংস্থান = Constitution
সংস্থাপন = Establishment
সংস্পর্শ = Touch
সংহতি = Solidity
সংহার = Slaughter
সংহিত = Joined
সংহিতা = Collection
সকণ্টক = Thorny
সকাল = Dawn
সকাশ = Vicinity
সক্রিয় = Active
সক্ষম = Able
সখা = Companion
সখীত্ব = Friendship
সঘন = Thick
সঙ = Clown
সঙ্কলন = Collection
সঙ্কল্প = Will
সঙ্কীর্ণ = Narrow
সঙ্কুচিত = Contracted
সঙ্কেত = Intimation
সঙ্কোচ = Contraction
সঙ্গ = Association
সঙ্গম = Intercourse
সঙ্গী = Companion
সঙ্গীত = Music
সঙ্গে = With
সঙ্ঘ = Society
সচকিত = Startled
সচরাচর = Usually
সচল = Moving
সচিব = Secretary
সচেষ্ট = Active
সচ্চরিত্র = Virtuous
সচ্ছল = Solvent
সচ্ছিদ্র = Porous
সজনী = Confidante
সজাগ = Awake
সজীব = Alive
সজোরে = Forcibly
সজ্জন = Equipment
সজ্জা = Dress
সজ্জিত = Dressed
সজ্ঞান = Aware
সঠিক = Genuine
সডাক = Expressing
সড়ক = Highway
সড়কি = Spear
সতর্ক = Cautious
সতী = Faithful
সতীর্থ = Fellow-student
সত্তা = Existence
সত্ত্ব = Being
সত্য =  true
সত্যি = Truth
সদন = Dwelling
সদম্ভ = Arrogant
সদয় = Kind
সদস্য = Member
সদা = Always
সদিচ্ছা = Noble intention
সদৃশ = Similar
সদ্য = At once
সন = Year
সনদ = Certificate
সনাতন = Eternal
সন্তান = Children
সন্তাপ = Glow
সন্তুষ্ট = Satisfied
সন্ত্রাস = Terror
সন্দিহান = Exciting
সন্দেহ = Doubt
সন্ধান = Search
সন্ধানী = Searching
সন্ধি = Junction
সন্ধ্যা = Dusk
সন্ন্যাসী = Devotee
সপ্তাহ = Week
সফর = Travel
সফল = Successful
সফেদ = White
সবজি = Vegetables
সবল = Powerful
সবাক = Talking
সবিনয় = Modest
সবিরাম = Intermittent
সবিশেষ = Detailed
সবুজ = Green
সভা = Meeting
সম = Same
সমক্ষ = Present
সমগ্র = All
সমঝ = Understanding
সমঞ্জস = Proper
সমতল = Plain
সমতা = Equality
সমতুল্য = Equivalent to
সমদূরবর্তী = Equidistant
সমদৃষ্টি = Look alike
সমদ্বিবাহু = Isosceles
সমদ্বিভুজ = Isosceles
সমধিক = More
সমন্বয় = Combination
সমন্বিত = Integrated
সমবয়সী = Same age
সমবয়স্ক = Same age
সমবর্তিতা = Concurrency
সমবর্তিনী = Concurrent
সমবায় = Cooperative
সমবাহু = Equilateral
সমবেত = Assembled
সমবেদনা = Compassion
সমব্যথা = Sympathies
সমভাবাপন্ন = Equivalent
সমভূমি = The plain
সমমূল্য = Equal value
সময় = The time
সময়োচিত = Timely
সময়োপযোগী = Timely
সমর্থ = Capable of
সমর্থন = Support
সমর্পণ = Surrender
সমর্পিত = Surrendered
সমষ্টি = Sum
সমস্যা = Problem
সমাক্ষ = Parallel
সমাক্ষরেখা = Parallel
সমাগম = Gathering
সমাজ = Society
সমাদর = Regards
সমাধান = Solution
সমাধি = Tomb
সমাধিক্ষেত্র = Cemetery
সমাধিস্থ = Buried
সমান = Equal
সমানুপাত = Proportion
সমান্তর = Parallel
সমান্তরাল = Parallel
সমাপতন = End
সমাপিকা = Finale
সমাপ্ত = Finished
সমাপ্তি = The end
সমাবর্তন = Convocation
সমাবৃত্ত = Integral
সমাবেশ = Assembly
সমার্থ = Ability
সমার্থক = Synonymous
সমালোচক = The critic
সমালোচনা = Criticism
সমাহার = Collection
সমাহিত = Buried
সমীকরণ = Equation
সমীক্ষা = Survey
সমীচীন = Expedient
সমীপ = Near
সমীহ = Same
সমুদয় = Community
সমুদ্র = Sea
সমুন্নত = Advanced
সমুন্নতি = Improvement
সমূল = Root
সমৃদ্ধ = Rich
সমৃদ্ধশালী = Prosperous
সমৃদ্ধি = Prosperity
সমেত = Including
সম্পত্তি = Property
সম্পদ্‌ = Wealth
সম্পন্ন = Completed
সম্পর্ক = Relationship
সম্পাদন = Execution
সম্পূর্ণ = Complete
সম্পৃক্ত = Involved
সম্প্রচার = Broadcast
সম্প্রতি = Recently
সম্প্রদান = Grant
সম্প্রদায় = Community
সম্প্রসারণ = Expansion
সম্প্রসারিত = Extended
সম্প্রীতি = Harmony
সম্বন্ধী = Related
সম্বল = Content
সম্বলহীন = Penniless
সম্বলিত = Containing
সম্ভব = Possible
সম্ভবত = Probably
সম্ভাবনা = Possibility
সম্ভাব্য = Possible
সম্ভাষণ = Salutation
সম্ভ্রম = Honor
সম্ভ্রান্ত = Noble
সম্মত = Agreed
সম্মতি = Consent
সম্মান = Respect
সম্মিলন = Combination
সম্মিলিত = Combined
সম্মুখ = Front
সম্মুখীন = Facing
সম্মেলন = Conference
সম্মোহন = Hypnosis
সম্মোহিত = Hypnotized
সম্রাজ্ঞী = Empress
সম্রাট = Emperor
সযত্ন = Careful
সয়তান = Devil
সরকার = Govt
সরকারি = Official
সরগরম = Hot
সরঞ্জাম = Tools
সরণী = Array
সরবত = Always
সরবরাহ = Supply
সরল = Simple
সরলকোণ = Right angle
সরলতা = Simplicity
সরলরেখা = Straight line
সরলীকরণ = Simplification
সরস = Juicy
সরা = Move
সরানো = To move
সরাসরি = Directly
সরিষা = Mustard
সরীসৃপ = Reptile
সরোবর = Lake
সর্ত = Conditions
সর্তসাপেক্ষ = Conditional
সর্দি = Cold
সর্দিকাশি = Cold
সর্প = Snake
সর্ব = All
সর্বকনিষ্ঠ = Youngest
সর্বক্ষণ = All the time
সর্বগামী = Omnivorous
সর্বগ্রাস = Totalitarian
সর্বজন = Everyone
সর্বজ্ঞ = Omniscient
সর্বত = All
সর্বত্যাগী = Self-sacrificing
সর্বত্র = Everywhere
সর্বদা = Always
সর্বনাম = Pronoun
সর্বনাশ = Apocalypse
সর্বব্যাপী = Omnipresent
সর্বভক্ষ = Omnivore
সর্বময়ী = Eternal
সর্বশ্রেষ্ঠ = Greatest
সর্বসম্মতি = Unanimity
সর্বাঙ্গ = Whole body
সর্বাত্মক = Comprehensive
সর্বোপরি = Above all
সলাপরামর্শ = Consultation
সশব্দ = Word
সশরীর = Of the body
সশস্ত্র = Armed
সসীম = Finite
সস্তা = Cheap
সহ = Including
সহকর্মী = Colleague
সহচারিণী = Wife
সহজ = Easy
সহজজ্ঞান = Common sense
সহধর্মিণী = Wife
সহন = Endurance
সহনশীল = Tolerant
সহপাঠী = Classmate
সহবাস = Intercourse
সহযাত্রী = Fellow traveler
সহযোগ = Support
সহযোগিতা = Cooperation
সহসা = Immediately
সহস্র = Thousand
সহা = Support
সহানুভূতি = Sympathy
সহাবস্থান = Coexistence
সহায়ক = Helpful
সহায়তা = Assistance
সহায়সম্পত্তি = Resources
সহি = Correct
সহিষ্ণু = Tolerant
সহে = With]
সহোদর = Brother
সাঁঝ = Evening
সাঁট = Close
সাঁটা = Swim
সাঁতার = Swimming
সাঁতারু = Swimmer
সাংকেতিক = Symbolic
সাংগঠনিক = Organizational
সাংবাদিক = Journalist
সাংসারিক = Family
সাংস্কৃতিক = Cultural
সাইকেল = Bicycle
সাইনবোর্ড = Signboard
সাকরেদ = The sugar
সাকার = Shape
সাক্ষর = Literate
সাক্ষরতা = Literacy
সাক্ষাত্‌ = Meeting
সাক্ষী = Witness
সাক্ষ্য = Testimony
সাগর = Sea
সাগু = Sago
সাগ্রহ = Eagerly
সাঙ্কেতিক = Symbolic
সাঙ্ঘাতিক = Fatal
সাজসজ্জা = Decoration
সাজসরঞ্জাম = Outfit
সাড়াশব্দ = Response word
সাদর = Regards
সাদামাঠা = Simple
সাদাসিধে = Naively
সাদৃশ্য = Analogy
সাধক = Saint
সাধনা = Pursuit
সাধারণ = General
সাধু = Saint
সাধুবাদ = Applause
সাধ্য = Able
সানন্দ = Pleasure
সানাই = Sanai
সান্ত্বনা = Consolation
সান্ধ্য = Evening
সান্ধ্যআইন = Evening law
সান্নিধ্য = Proximity
সাপ = Snake
সাফল্য = Success
সাবধান = Careful
সাবলীল = Fluent
সাবান = Soap
সামগ্রী = Content
সামঞ্জস্য = Compatibility
সামনা = In front of
সাময়িক = Temporary
সামরিক = Military
সামর্থ্য = Ability
সামাজিক = Social
সামান্তরিক = Parallel
সামান্য = A little
সামুদ্রিক = Marine
সাম্প্রতিক = Recent
সাম্প্রদায়িক = Communal
সাম্যবাদ = Communism
সাম্রাজ্য = Empire
সায়াহ্ন = In the evening
সায়েস্তা = Siesta
সারক = Fertilizer
সারণী = Table
সারথি = Charioteer
সারশূন্য = Pointless
সারি = Queue
সারিবদ্ধ = Lined up
সার্কাস = Circus
সার্বজনীন = Universal
সার্বভৌম = Sovereign
সার্বিক = Overall
সালাম = Hello
সালিশ = Arbitration
সাশ্রয় = Savings
সাহচর্য = Companionship
সাহস = Courage
সাহসিকতা = Bravery
সাহিত্য = Literature
সাহিত্যচর্চা = Literary practice
সাহিত্যিক = Literary
সিঁদকাটা = Cut off
সিঁদুর = Vermilion
সিংহ = Lion
সিংহাসন = Throne
সিক্ত = Wet
সিগন্যাল = Signal
সিগারেট = Cigarettes
সিদ্ধান্ত = Decision
সিদ্ধি = Achievement
সিনেমা = Movie
সিন্দুক = Ark
সিপাহী = Soldier
সিমেন্ট = Cement
সিরিশকাগজ = Tissue paper
সীমা = Limit
সীমানা = Border
সীমাবদ্ধ = Limited
সীমিত = Limited
সীলমোহর = Seal
সীসা = Lead
সুই = Needle
সুকীর্তি = Fame
সুখ = Happiness
সুখী = Happy
সুগন্ধ = Fragrance
সুগম্য = Accessible
সুটকেস = Suitcase
সুড়ঙ্গ = Tunnel
সুড়সুড়ি = Tickling
সুতা = Yarn
সুতি = Cotton
সুদখোর = Usurer
সুদূর = Far away
সুনির্দিষ্ট = Specific
সুপারিশ = Recommendation
সুবচন = Good speech
সুবর্ণ = Gold
সুবলিত = Well-built
সুবা = Province
সুবাদ =  relation
সুবাস = Fragrance
সুবাসিত = Perfumed
সুবিধা =  advantage
সুবুদ্ধি = Prudence
সুবোধ = Good sense
সুযোগ = Good opportunity
সুযোগ্য = Capable
সুর = Divinity
সুরস = Juicy
সুরা = Wine
সুরুচি = Fine taste
সুরূপ = Handsome
সুলক্ষণ = Auspicious sign
সুলতান = King
সুলতানী = Regal
সুলভ = Available
সুশীতল = Freezing
সুশীল = Good tempered
সুশ্রাব্য = Melodious
সুশ্রী = Handsome
সুষম = Balanced
সুষুম্না = Spinal cord
সুষ্ঠু = Good
সুসম্পন্ন = Well finished
সুস্থ = Healthy
সুস্থিত = Well established
সুস্থির = Very firm
সুস্নিগ্ধ = Very gentle
সুস্পষ্ট = Very clear
সূক্ষ্ম = Small
সূচ = Needle
সূচক = Indicating
সূচন = Beginning
সূচি = Needle
সূচিত = Pointed out
সূচ্যগ্র = Point of a needle
সূতা = Thread
সূপ = Soup
সূর্য = Sun
সূর্যকর = Sunbeam
সূর্যস্নান = Sunbath
সূর্যালোক = Sunlight
সূর্যাস্ত = Sunset
সূর্যোদয় = Sunrise
সৃজন = Creation
সৃতি = Wandering
সৃষ্ট = Created
সৃষ্টি = Creation
সে = He/she
সেকা = Toast
সেকাল = Past
সেখান = There
সেচ = Sprinkling
সেজ = Bed
সেজদা = Prostration
সেতার = Sitar
সেতু = Bridge
সেথা = Bridge
সেনা = Soldier
সেবন = Sewing
সেবা  = Service
সেবিত = Enjoyed
সেবী = Serving
সেয়ান = Shrewd
সেরা = Best
সেরেফ = Only
সেরেস্তা = Office
সেলাই = Sewing
সৈকত = Sea beach
সৈনিক = Soldier
সৈন্ধব = Oceanic
সৈন্য = Soldier
সোজা = Straight
সোনা = Gold
সোপর্দ = Charge
সোপান = Stairs
সোফা = Sofa
সোম = The moon
সোর = Noise
সোহাগ = Love
সৌগন্ধ = Fragrance
সৌজন্য = Goodness
সৌধ = Palace
সৌন্দর্য = Beauty
সৌবর্ণ = Golden
সৌভাগ্য = Good luck
সৌভিক = Juggler
সৌম্য = Placid
সৌর = Solar
সৌহার্দ্য = Affection
স্কন্ধ = Shoulder
স্কলারশিপ = Scholarship
স্কুল = School
স্কুলমাস্টার
স্ক্রু = Screw
স্ট্যাম্প = Stamp
স্তন = Female breast
স্তনিত = Sounding
স্তন্য = Milk
স্তব = Praise
স্তম্ভ = Pillar
স্তর = Layer
স্তিমিত = Still
স্তুত = Praised
স্তুতি = Praise
স্তূপ = Heap
স্তোত্র = Eulogy
স্ত্রী = Wife
স্ত্রৈণ = Female
স্থবির = Old
স্থল = Place
স্থাণু = Stump
স্থান = Place
স্থায়ী = Lasting
স্থাল = Vessel
স্থিত = Situated
স্থির = Firm
স্থূল = Fat
স্থৈর্য = Calmness
স্নাত = Bathed
স্নান = Bathing
স্নায়বিক = Nerval
স্নায়ু = Nerve
স্নিগ্ধ = Soft
স্নেহ = Oil
স্পন্দন = Throb
স্পন্দিত = Quivering
স্পর্ধা = Daring
স্পর্ধিত = Defiant
স্পর্শ = Touch
স্পষ্ট = Clear
স্পিরিট = Spirit
স্পৃশ্য = Sensible
স্পৃষ্ট = Touched
স্পৃহা = Desire
স্ফটিক = Crystal
স্ফার = Shock
স্ফীত = Swollen
স্ফীতি = Bulkiness
স্ফুট = Open
স্ফুরণ = Trembling
স্ফুরিত = Throbbing
স্ফুলিঙ্গ = Spark
স্ফূর্তি = Merriment
স্ফোট = Swelling
স্ফোটন = Crushing
স্ব = Own
স্বকর্ম = Own work
স্বকীয় = Own
স্বচ্ছ = Transparent
স্বচ্ছন্দ = Free will
স্বজন = Own kind
স্বতন্ত্র = Independent
স্বত্ব = Right
স্বদেশ = Own country
স্বদেশী = Native
স্বনাম = One's own name
স্বপ্ন = Dream
স্বভাব = Nature
স্বয়ং = Oneself
স্বর = Sound
স্বরাষ্ট্র = Own state
স্বরূপ = Own
স্বর্গ = Heaven
স্বর্ণ = Gold
স্বল্প = Very little
স্বাক্ষর = Sign
স্বাক্ষরিত = Signed
স্বাগত = Welcome
স্বাজাতিক = Nationalistic
স্বাতন্ত্র্য = Freedom
স্বাদ = Taste
স্বাদিত = Tasted
স্বাধিকার = Autonomy
স্বাধীন = Free
স্বাবলম্ব = Self reliance
স্বাবলম্বী = Self-reliant
স্বাভাবিক = Natural
স্বামী = Husband
স্বায়ত্ত = Dependent on oneself
স্বার্থ = Self interest
স্বাস্থ্য = Health
স্বাস্থ্যোদ্ধার = Recovery
স্বীকার = Acceptance
স্বীকারোক্তি = Confession
স্বীকার্য = Acceptable
স্বীকৃত = Accepted
স্বীকৃতি = Recognition
স্বীয় = Peculiar
স্বেচ্ছা = Free will
স্বেদ = Sweat
স্বেদন = Sweating
স্বৈর = Willfulness
হ = The thirty third and last consonant of the Bengali alphabet
হংস = Goose
হওয়া = Be
হক = Truth
হকচকানো = Wobble
হকার = Hawker
হকিয়ত = Ownership right
হজ = Pilgrimage to mecca
হজম = Digestion
হজমী = Digestive
হজরত = Dignity
হট = Indicating
হটা = Move aside
হট্ট = Market
হঠ = Violence
হড়্‌কা = Slippery
হণ্ডী = Pot
হত = Smitten
হতাশ = Disappointed
হতে = From
হত্যা = Killing
হদিস = Whereabouts
হদ্দ = Extreme
হনহন = Expressing
হনূ = Jaw
হন্তদন্ত = Flurried
হন্তা = Killer
হন্যা = Murderous 
হবনী = Sacrificial ladle
হবু = Would be
হয়তো = Perhaps
হয়রানি = Fatigue
হর = Any
হরকত = Hindrance
হরতন = Hearts
হরপ = Character
হররা = Roars
হরি = Moon
হরিণ = Deer
হরিত = Green
হরেক = Different
হর্তা = Destroyer
হর্ম্য = Palace
হর্ষ = Joy
হর্ষিত = Gladdened
হল = Gliding
হলফ = Oath
হলুদ = Tumeric
হস্ত = Hand
হস্তিপ = Elephant keeper
হস্তী = Elephant
হাঁটা = Walk
হাঁদারাম = Fool
হাই = Yawn
হাউমাউ = Loud cry
হাউস = Desire
হাওয়া = Wind
হাওয়াগাড়ি = Motor car
হাওয়াবদল = Change of air
হাওর = Extensive marsh
হাওলা = Custody
হাকিমী = Magistracy
হাজা = Be spoil
হাজার = Thousand
হাজির = Present
হাট = Market
হাটুরে = Market man
হাডুডু = Bengali outdoor game
হাড় = Bone
হাত = Hand
হাতজোড় = Plead
হাতড়ান = Grope
হাতা = Limits
হানা = Drive
হাফ = Half
হাব = Attitude
হাবড়া = Talkative
হাবিজাবি = Rubbish
হাভাত = Beggar
হাভাতে = Beggarly
হাম = Measles
হামানদিস্তা = Mortar
হামেশা = Always
হায় = Alas
হায়া = Modesty
হার = Defeat
হারেম = Harem
হার্দ = Love
হার্দিক = Tender
হাল = State
হালকা = Light
হালাক = Ruined
হালাল = Legal
হাসা = Smile 
হাসি = Laughter
হাস্য = Laugh
হাস্যকর = Funny
হাহা = Loud Laughter
হাহুতাশ = Profound regret
হিংসা = Malice
হিংসুক = Envious
হিংস্র = Fierce
হিঙ্গুল = Cinnabar
হিজড়া = Hegira
হিজিবিজি = Scrawly
হিড়হিড় = Indicating
হিড়িক = Craze
হিত = Benefit
হিতাকাঙ্ক্ষী = Well wisher
হিতাহিত = Good and evil
হিতাহিতজ্ঞান = Moral sense
হিতৈষী  = Well wishing
হিন্তাল marshal date tree
হিন্দি = Hindi
হিন্দু = Hindu
হিন্দুত্ব = Hinduism
হিন্দুধর্ম - Hindu religion
হিন্দুসমাজ = Hindu society
হিন্দুস্থান = India
হিন্দুস্থানী = Indian
হিব্রু = Hebrew
হিম = Frost
হিমগিরি = Himalayan mountain
হিমবাহ = Glacier
হিমশিম = Extreme
হিমশীতল = Frosty
হিমশৈল = Iceberg
হিমসাগর = Sea of snow
হিমাগম = Approach a cold
হিম্মত = Spirit
হিয়া = Heart
হিল্লোল = Swing
হিসাব = Counting
হিসেবপরীক্ষক = Auditor
হিসেবপরীক্ষা = Audit
হিসেবি = Accountable
হিস্টিরিয়া = Hysteria
হীনতা = Defectiveness
হীনম্মন্যতা = Inferiority complex
হীরক = Diamond
হীরকজয়ন্তী = Diamond jubilee
হীরা = Diamond
হুকুম = Command
হুজুগে = Crazy
হুজুর = Presence
হুবহু = Identical
হুমকি = Threat
হুমড়ি = Tumble
হুর = Virgin of paradise
হুল = Sting
হুলস্থূল = Uproar
হুল্লোড় = Revelry
হৃত্‌পিণ্ড = Heart
হৃত্‌স্পন্দন = Heartbeat
হৃদয় = Heart
হৃদয়বান্‌ = Generous
হৃদয়বিদারক = Pathetic
হৃদয়বেদনা = Heart ache
হৃদয়শূন্য = Heartlessness
হৃদ্‌রোগ = Heart decease
হৃষ্ট = Rejoiced
হৃষ্টপুষ্ট = Plump 
হেন = Like
হেনস্তা = Harassment
হেফাজত = Guarding
হেমন্ত = Autumn
হেমন্তকাল = Autumn
হেরো = Loser
হৈচৈ = Uproar
হোটেল = Hotel
হোটেলওয়ালা = Hotelier
হোমিওপ্যাথি = Homeopathy
হোস্টেল = Hostel
হ্রদ = Lake
হ্রাস = Decrease

