a = এক, ইংরেজী বর্ণমালার আদ্যাক্ষর, ইংরেজি বর্ণমালার প্রথম অক্ষর
aback = বিস্মিত, পিছনদিকে
abacus = গননা শিক্ষার ফ্রেম বিশেষ
abaddon = নরক
abaft = জাহাজের পিছনের দিকে
abandon = পরিত্যাগ করা
abandoned = পরিত্যক্ত
abandonment = বর্জন
abase = হীনপদস্থ করা
abased = নিচের দিকে
abasement = নীচতা
abash = লজ্জা দেওয়া
abashed = হতভম্ব
abashment = বিহ্বলতা
abate = প্রকোপ হ্রাস করা
abated = কমান
abatement = কম করা
abattoir = কসাইখানা
abbess = মঠধারিণী
abbey = সন্ন্যাসী বা সন্ন্যাসিনীদের মঠ
abbot = মঠাধ্যক্ষ
abbreviate = সংক্ষিপ্ত
abc = বর্ণমালা = কোনো বিষয়ের প্রাথমিক জ্ঞান
abdicate = সিংহাসন ত্যাগ করা
abdication = পরিত্যাগ
abdomen = তলপেট
abdominal = উদর ঘটিত
abduct = অপহরণ করা
abducting = অপহারক
abduction = অপহরণ
abed = শয্যায়
aberrance = বিচ্যুতির ঘটনা
aberrant = বিচ্যুত
aberration = বিপথগামিতা
abet = অসৎ কাজে মদত দেওয়া
abetment = বিবাদসৃষ্টির স্বভাব সহায়তা সাহায্য আনুকূল্য পোষকতা
abetter = কুকর্মে সাহায্যকারী
abetting = পোষক
abettor = যোগদানকারী পোষক
abeyance = স্থগিতাবস্থা
abhor = গভীর ঘৃণার চোখে দেখা
abhorrent = জঘন্য, ঘৃণ্য
abide = থাকা = বাস করা
abide by = বিশ্বস্ত থাকা
abiding = স্থায়ী
ability = যোগ্যতা
abject = শোচনীয়
abjection = চরম দুর্দশা
abjectly = শোচনীয়ভাবে
abjuration = শপথপূর্বক পরিত্যাগ
abjure = শপথপূর্বক বর্জন করা
ablation = অপসারণ
ablative = অপাদান কারক
ablaut = অপশ্রুতি
ablaze = জ্বলন্ত
able = যোগ্য
able bodied = সক্ষম
abloom = প্রস্ফুটিত
ablution = পুণ্যস্নান
ably = যোগ্যতার সঙ্গে
abnegation = অস্বীকার নামঁজুরি প্রত্যাখ্যান
abnormal = অস্বাভাবিক
abnormality = নিয়মের ব্যতিক্রম
abnormally = অস্বাভাবিকভাবে
aboard = জাহাজ, বিমান নৌকা প্রভৃতির ওপরে বা মধ্যে
abode = অধিবাস
abolish = বাতিল করা
abolished = রহিত
abolishment = বাতিল রদ
abolition = রদ
abolition of posts = পদবিলুপ্তি
abolitionist = মৃত্যুদণ্ডবিলোপপন্থী
abominable = ঘৃণ্য
abominate = মনেপ্রাণে ঘৃণা করা
abomination = তীব্র ঘৃণা ও বিরাগ
aborasion = ঘর্ষণ
aboriginal = আদিম
aborigine = আদিম অধিবাসী
aborigines = আদিম নিবাসী
abort = বাতিল
abortion = গর্ভপাত
abortive = নিষ্ফল
abortively = বৃথা নিষ্ফলতায়
abound = সংখ্যায় যথেষ্ট
about = পরিচিতি, সংক্রান্ত, সম্বন্ধে, প্রায়
above = উপরেsett
abracadabra = যাদুকরের আওড়ানো মন্ত্র
abrade = ঘষে তুলে ফেলা
abraded = ঘর্ষিত
abrasion = ঘর্ষণজনিত ক্ষয়
abrasive = ক্ষয়কারী
abreast = পাশাপাশি
abroad = বিদেশ
abridge = সংক্ষিপ্ত করা
abridged = সংক্ষেপিত
abridgement = সংক্ষেপ করণ
abroad = ব্যাপকভাবে
abrogate = বিলোপ করা
abrogation = রদ
abrupt = অপ্রত্যাশিত
abruptly = হঠাৎ
abruptness = আকস্মিকতা
abscess = ফোড়া
abscissa = ভুজ
abscond = আত্মগোপন করে থাকা
absconder = আত্মগোপনকারী
absconding = পলান
absence = অনুপস্থিত
absent = অনুপস্থিত
absentee = অনুপস্থিত লোক
absenteeism = নিজ গৃহ হতে প্রায় বাহিরে থাকার স্বভাব
absentmindedly = অন্যমনস্কভাবে
absinth = সোমরাজ গাছ বা তার নির্যাস
absinthe = সোমরস
absolute = পরম
absolutely = বিনা শর্তে
absolution = দন্ড হতে অব্যহতি
absolutism = স্বৈরতন্ত্র শাসকের শাসন
absolve = অপারাধ হতে মুক্ত বলে ঘোষনা করা
absorb = শুষে নেওয়া
absorbability = শোষণপ্রবণতা
absorbable = শোষণযোগ্য
absorbed = বিশোষিত
absorbent = শুষে নিতে পারে এমন
absorbing = অত্যান্ত চিত্তাকর্ষক
absorption = শোষণ
absorptive = শোষণক্ষম
abstain = বিরত থাকা
abstemious = সংযমী
abstention = ক্ষান্তি
abstinent = সংযমী, মিতাচারী
abstract = বস্তুনিরপেক্ষ
abstracted = অন্যমনস্ক
abstraction = অন্যমনস্কতা
abstruse = দুর্বোধ্য
absurd = অসংগত
absurdity = অসংগতি
abundance = যথেষ্ট
abundant = অধিক
abuse = অপব্যবহার
abuses = অপব্যবহার
abusive = নিন্দাময়
abysmal = অতল স্পর্শ
abyss = অতল গহ্বর
acacia = একরকম আঠা-নিঃসারী গাছ
academic = শিক্ষায়তনিক
academician = অ্যাকাডেমির সদস্য
academy = উচ্চশিক্ষায়তন = পণ্ডিতসভা
accede = রাজী হওয়া
accelerate = দ্রুততর করা
acceleration = ত্বরণ
accelerator = গতিবর্ধক
accent = ধ্বনির তীব্রতা
accept = গ্রহণ করা
acceptability = গ্রহণযোগ্যতা
acceptable = গ্রহনযোগ্য
acceptance = গ্রহণযোগ্যতা
acceptation = স্বীকৃতি
accepted = গৃহিত
access = প্রবেশাধিকার
accessed = ব্যবহৃত
accessibility = প্রবেশযোগ্যতা
accessible = উপলভ্য
accession = উত্তীর্ণ হওয়া
accessory = আনুষঙ্গিক
accident = দূর্ঘটনা
accidental = আকস্মিক
accidentally = দুর্ঘটনাবশত
acclaim = প্রশংসা
acclamation = প্রশংসা
acclimate = নূতন জলবায়ু সহ্য করিতে অভ্যস্ত করান
acclimation = আবহাত্তয়ায় অভ্যস্তকরণ
acclimatization = অভিযোজন
accommodate = সমন্বয়বিধান করা
accommodating = মানিয়া নিতে পারে এমন
accommodation = বাসস্থান
accompanied = অনুষঙ্গী
accompany = সহগমন করা
accompanying = অনুযাত্রিক
accomplice = দুষ্কমের সহচর
accomplish = সুসম্পন্ন করা
accomplished = গুণান্বিত
accomplishment = সম্পাদন
accord = অনুযায়ী হওয়া
accordance = সামঞ্জস্য
according = অনুযায়ী
accordingly = তদনুসারে
accordion = বাদ্যযন্ত্র বিশেষ
accost = খদ্দের ডাকা
accosting = সম্ভাষণ
accouchement = সন্তান প্রসব
account = গণনা করা, বিবেচনা করা
accountancy = হিসাবরক্ষকের পেশা
accountant = হিসাবরক্ষণ
accountability = জবাবদিহিতা
accountable = কৈফিয়ত দেওয়ার জন্য বাধ্য
accountant = হিসাবরক্ষক
accounting = হিসাবরক্ষণ
accounts = অ্যাকাউন্ট
accretion = পরিবৃদ্ধি
accrue = অর্জন
accucheur = যে পুরুষ প্রসবের কার্যে ধাত্রীকে সাহায্য করে
accumulate = জড়ো করা
accumulated = সমষ্টিকৃত
accumulation = সঞ্চয়
accumulator = সঞ্চয়কারী
accuracy = নির্ভুলতা
accurate = নির্ভূল
accurately = সঠিকভাবে
accusation = অভিযোগ
accuse = অভিযোগ করা
accused = অভিযুক্ত
accustom = অভ্যস্ত করানো
accustomed = অভ্যস্ত
ace = টেক্কা
acetic = ভিনিগার বা সিরকা সম্বন্ধীয়
ache = বেদনা, ব্যাথা করা
achievable = সাধনযোগ্য
achieve = অর্জন
achievement = অর্জন
achievements = অর্জনসমূহ
acid = অম্ল
acidity = অম্লতা
acknowledge = প্রাপ্তিস্বীকার করা
acknowledgement = স্বীকার
acknowledgment = কৃতজ্ঞতাস্বীকার
acme = শীর্ষ
acne = মুখব্রণ
acolyte = অনুচর
acorn = ওক গাছের ফল
acoustic = শ্রবণেন্দ্রিয় সংক্রান্ত
acoustical = ধ্বনিতাত্বিক
acquaint = পরিচিত করানো
acquiescence = মৌনসম্মতি
acquire = অর্জন করা
acquired = অর্জিত
acquisition = অর্জন
acquisitive = অর্জন করিতে ইচ্ছুক
acquit = বেকসুর খালাস দেওয়া
acquittal = আদালতের বিচারে খালাস
acre = ৪৮৪০ বর্গগজ পরিমিত স্থান
acreage = কোন এক খন্ড জমিতে একরের সংখ্যা
acrid = তিক্ত
acrimonious = উগ্র
acrimony = স্বভারের রুক্ষতা
acrobat = ব্যায়ামকুশলী
acrobatic = মল্লক্রীড়া সম্বন্ধীয়
across = আড়াআড়ি
act = কর্ম
acted = অভিনীত
acting = সাময়িকভাবে অন্যের স্থলাভিষিক্ত
acting = কার্যবাহী
actinic = বিকারক
actinic rays = বিকারক রশ্মি
actinism = বিকারক ধর্ম
action = কাজ
actionable = মোকদ্দমার যোগ্য
actions = ক্রিয়া
activate = সক্রিয়
activate = সক্রিয়করণ
activated = সক্রিয়
activation = সক্রিয়করণ
active = সক্রিয়, কার্যকর
actively = সক্রিয়ভাবে
activist = সক্রিয়তাবাদী ব্যক্তি
activities = ক্রিয়াকলাপ
activity = ক্রিয়াকর্ম
actor = অভিনেতা
actress = অভিনেত্রী
actual = আসল
actually = প্রকৃতপক্ষে
actuary = বিমা সম্বন্ধীয় দক্ষ ব্যক্তি
actuate = কার্যে প্রবিত্ত করা
acquiesce = নীরবে সম্মতি দেওয়া
acumen = তীক্ষ্ণ বিচারশক্তি, সূক্ষ্মদর্শিতা
acute = তীব্র, ধারালো
acuteness = সূক্ষ্মদর্শিতা
ad = বিজ্ঞাপন
adage = প্রবচন
ad agency = বিজ্ঞাপণী সংস্থা
adam = আদম
adamant = হীরা বা ঐ জাতীয় অতি কঠিন বস্তু
adamantine = ইচ্ছা শক্তিতে শক্তিশালী
adamantly = কঠোরভাবে
adapt = খাপ খাওয়ানো
adaptation = অভিযোজন
adapted = অভিযোজিত
add = যোগ করা
addendum = সংযোজন
adder = যোজক
addict = একান্তভাবে আসক্ত হওয়া
addicted = আসক্ত
addiction = আসক্তি
addictive = অভ্যাসজনক
addition = যোগ প্রক্রিয়া
additional = অতিরিক্ত, ঐচ্ছিক, বাড়তি
additive = যোজনীয়
addle = গোলানো
addle brained = নিবোর্ধ
addled = ঘোলা
address = সম্বোধন করা
addressbook = ঠিকানা বই
addressed = উদ্দিষ্ট
addressing = সম্ভাষণ
adduce = উদ্বুদ্ধ করা
adept = সুদক্ষ
adeptness = পারদর্শিতা
adequacy = প্রাচুর্য
adequate = পর্যাপ্ত
adhere = লেগে থাকা
adherent = সংলগ্ন
adhering = সংশ্লিষ্ট
adhesion = আসক্তি
adhesive = আঠালো
adhesive power = আঠালো ক্ষমতা
adhesive stamp = আঠাযুক্ত স্ট্যাম্প
adhesiveness = আঠাল
adhoc = বিশেষ উদ্দেশে গঠিত
adieu = বিদায়
adipose = মেদবহুল = মেদজ
adiposity = স্থূলতা
adit = সুড়ঙ্গ
adjacency = নৈকট্য
adjacent = সন্নিহিত
adjacent angle = সন্নিহিত কোণ
adjective = বিশেষণ
adjoin = সংযুক্ত করা
adjoining = পাশাপাশি
adjourn = স্থগিত রাখা
adjourned = মুলতুবী
adjournment = বিরতি
adjudge = মীমাংসা করা
adjudged = সাব্যস্ত
adjudicate = আইন মোতাবেক মীমাংসা করা
adjudication = ন্যায়-নির্ণয়ণ
adjudicator = ন্যায়নির্ণায়ক
adjunct = অধস্তন সহকারী
adjunction = ক্রোড়পত্র
adjuration = শপথ গ্রহণ
adjure = শপথ করানো
adjust = অভিযোজিত করা
adjustable = নিয়ন্ত্রন যোগ্য
adjutant = উচ্চপদস্থ সামরিক অফিসারের সহকারী
administer = পরিচালনা করা
administration = পরিচালন
administrative = প্রশাসনিক
administrator = প্রশাসক
admirable = প্রশংসনীয়
admiral = নৌসেনাপতি
admiration = প্রশংসা
admire = প্রশংসা করা
admired = প্রশংসিত
admirer = উপাসক
admiring = উপাসক
admissibility = গ্রহণযোগ্যতা
admissible = গ্রহণযোগ্য
admission = ভর্তি
admit card = প্রবেশপত্র
admittance = প্রবেশাধিকার
admix = মিশ্রিত করা
admixed = সংমিশ্রিত
admixture = মিশ্রণ-প্রক্রিয়া
admonish = তিরস্কার করা
ado = গোলমাল
adobe = রৌদ্রপক্ব
adolescence = বয়ঃসন্ধিকাল
adolescent = নবযুবক, নবযুবতী
adonize = নিজেকে সজ্জিত করা
adopt = দত্তক গ্রহণ করা
adoptable = গ্রহণযোগ্য
adopted = আশ্রিত
adoption = দত্তকগ্রহণ
adorable = আদরণীয়
adoration = আরাধনা
adore = পুজো করা
adored = আরাধিত
adorn = অলংকৃত করা
adorned = সুশোভিত
adorning = শোভাকর
adrenal = বৃক্কের উপরিভাগে বা নিকটে অবস্থিত
adrenal gland = অ্যাড্রিনাল গ্রন্থি
adrenalin = অ্যাড্রিনাল থেকে নিঃসৃত হরমোন
adrift = ভেসে চলা
adroit = দক্ষ
adroitly = নিপুণভাবে
adroitness = কৌশল
adulate = তোষামোদ করা
adulation = তোষামোদ
adult = প্রাপ্তবয়স্ক
adulterant = ভেজালে ব্যবহৃত বস্তু
adulterate = বিশুদ্ধতা নষ্ট করা
adulteration = ভেজাল
adulterer = ব্যভিচারী
adulteress = ব্যভিচারিণী
adulterous = ব্যভিচারদুষ্ট
adultery = ব্যভিচার
adulthood = পূর্ণতাপ্রাপ্তি
adumbrate = কাঠামোটুকু তুলে ধরা
advalorem = মূল্যায়নুপাতে
advance = অগ্রগমন
advanced = অগ্রসার
advantage = সুবিধা
advantageous = সুবিধাজনক
advent = সমাগম, আবির্ভাব
adventitious = আকস্মিক
adventure = উত্তেজনাময়  অভিযান
adverb = ক্রিয়া-বিশেষণ, বিশেষণের বিশেষণ
adverbial = ক্রিয়া-বিশেষণ জাতীয়
adversary = বিপক্ষ
adverse = বিরোধী
adversity = প্রতিকূল অবস্থা
advert = দৃষ্টি আকর্ষণ করা
advertise = বিজ্ঞাপন দেওয়া
advertising = বিজ্ঞাপন
advice = পরামর্শ
advisability = সমীচীনতা
advise = উপদেশ
advisory = উপদেশক
advocacy = ওকালতি
advocate = ওকালতি করা
aegis = তত্ত্বাবধান
aeon = অনন্ত কাল
aerate = বাতাস প্রবেশ করানো
aerated = বাতান্বিত
aeration = বাতান্বয়ন
aerial = বায়বীয়
aerobic = বায়ুজীবী
aerodrome = বিমানবন্দর
aerodynamics = বায়ুগতিবিজ্ঞান
aerofoil = উড়জাহাজের পাখা
aerography = আবহবিদ্যা
aeronaut = বিমানচালক
aeronautics = বিমানচালনবিদ্যা
aeroplane = বিমান
aerosol = এরোসল
aerospace = মহাকাশ
aery = অত্যুচ্চ স্থানে নির্মিত শিকারি পাখির বাসা
aesthete = সুন্দরের পূজারী
aesthetic = নান্দনিক
aesthetical = সৌন্দর্য বিজ্ঞান বিষয়ক
aetiology = কারণ তত্ত্ব
afar = বহুদুরে
affability = ভদ্রতা
affable = অমায়িক
affair = ঘটনা
affairs = ব্যাপার
affect = প্রভাবিত করা
affectation = ভন্ডামি
affected = প্রভাবিত
affection = প্রীতি
affectionate = স্নেহাসক্ত
affects = প্রভাব
affiance = বাগদান করা
affianced = বাগ্দত্তা
affidavit = শপথপত্র
affiliate = শাখারূপে অন্তর্ভুক্ত হওয়া
affiliate = শাখারূপে অন্তর্ভুক্ত হওয়া
affiliated = অধিভুক্ত
affiliation = আসক্তি
affinity = অনুরাগ
affirmation = দৃঢ়োক্তি
affirmative = স্বীকৃতি সূচক
affix = লাগানো
afflict = পীড়া দেয়া, কষ্ট দেয়া
afflicted = পীড়িত
affliction = মানসিক ক্লেষ
affluence = প্রাচুর্য
afford = সমর্থ হওয়া
afforest = বনভূমিতে পরিণত করা
afforestation = বৃক্ষরোপণ
affray = হাংগামা
affront = প্রকাশ্যে অপমান করা
afield = মাঠে
afire = জ্বলন্ত
aflame = প্রদীপ্ত
afloat = ভাসমান
afoot = চলন্ত
afore = সামনে
aforementioned = পূর্বকথিত
aforethought = পূর্বকল্পিত
afraid = ভীত
afresh = নতুন করে
aft = পশ্চাদ্বর্তী
after = পরে
afternoon = অপরাহ্ন
afterwards = পরে
again = পুনরায়
against = বিরুদ্ধে
agape = হা করে
agate = অতি কঠিন পাথর
age = বয়স
aged = বয়স্ক
agelogn = বহু পুরাতন
agency = সংস্থা
agenda = সভায় আলচ্য বিষয় সূচি
agent = এজেন্ট
agents = দালাল
agglomerate = পিন্ড করা, জড়ো করা
agglomeration = পিন্ডীভূত হওয়া, জড়ো হওয়া
agglutinate = এঁটে দেওয়া = জুডে দেওয়া = সমাসবদ্ধ পদ রচনা করা
aggrandize = সম্মান বৃদ্ধি করা, ক্ষমতা বৃদ্ধি করা, সম্পদ বৃদ্ধি করা
aggrandizement = সম্প্রসারণ
aggravate = তীব্রতর করা
aggravated = কুপিত
aggravating = বিরক্তিকর
aggravation = প্রকোপ বৃদ্ধি
aggregate = মোট
aggregated = রাশীকৃত = একত্রিত
aggregately = সমষ্টিগতভাবে
aggregation = পুঞ্জীকরণ
aggression = বিবাদের সূত্রপাত
aggressive = আক্রমণাত্মক, উগ্র
aggressiveness = হামলাদারিতা, আগ্রাসনতা
aggressor = আক্রমণকারী দেশ
aggrieve = ব্যথিত করা
aggrieved = অবমানিত
aghast = ভীত
agile = দ্রুত এবং সবলীল
agility = দ্রুতমননশীলতা
aging = পক্বতা
agitate = আলোড়িত করা
agitated = উত্তেজিত
agitating = উদ্বেগজনক
agitation = অধীরতা
agitator = উত্তেজনা সৃষ্টিকারী
aglow = দীপ্ত
agglutionate = আঠা দ্বারা সংযুক্ত করা
agnail = আঙুলহাড়া
agnostic = অঞ্জেয়বাদী
agnosticism = অজ্ঞেয়বাদ
ago = অতীতে
agog = ব্যগ্র, উত্তেজিত
agonized = যন্ত্রণাকাতর
agonizing = মর্মান্তিক
agnomen = অতিরিক্ত নাম
agony = নিদারুণ মানসিক যন্ত্রণা
agrarian = কৃষিসম্পর্কীয়
agree = রাজি
agreed = একমত
agreeing = সম্মত
agreement = চুক্তি
agricultural = কৃষি-সংক্রান্ত
agriculturalist = কৃষিবিদ্, কৃষি বিদ্যায় নিপুন ব্যক্তি
agriculture = কৃষিবিদ্যা ও পশুপালন, চাষবাস
agriculturist = কৃষিবিদ্
agronomic = গ্রামীণ
agronomist = কৃষিতত্ত্ববিদ।
agronomy = কৃষি অর্থনীতি
aground = অগভীর জলে আটকে যাওয়া
ague = পালা জ্বর
ah = আহা, দুঃখ
ahead = আগে
aha = বিস্ময়
ahead = সম্মুখে
ahem = গলা খাকারি
ahoy = নাবিকদের মধ্যে পরস্পরকে অভিবাদন বা সর্তক করার সম্বোধন
aid = সাহায্য
aide = সহকারী
ail = কষ্ট দেওয়া
ailing = পীড়িত
ailment = ব্যাধি
aim = লক্ষ্য
air = বায়ু
airborne = বায়ুবাহিত
aircraft = বায়ুযান
airedale = খাড়া-খাড়া লোমবিশিষ্ট বৃহত্ শিকারি কুকুর বিশেষ
airing = খোলা বাতাসে বেড়ানো
airless = বায়ুশূন্য
airline = যাত্রিবাহি বিমান চলাচল
airliner = বিমান
airport = বিমানবন্দর
airpower = বায়ু শক্তি
airway = যে পথে নিয়মিত বিমান চলাচল করে
airy = বাতাস খেলে এমন
aisle = গির্জার আসনশ্রেণীর মধ্যবর্তী পথ
akin = একই বংশোদ্ভূত
al = আল
alarm = বিপদসংকেত, সংকেত
alarming = উদ্বেগ জনক
alarmingly = সাংঘাতিকভাবে
alas = হায়-হায়
albatross = সামুদ্রিক পক্ষি বিশেষ
album = অ্যালবাম
albums = অ্যালবাম
alchemy = কিমিয়া
alcohol = অ্যালকোহল
ale = মদ্য বিশেষ
alert = সতর্ক, সতর্ক করা, সাবধান করা
alfresco = মুক্ত বায়ুতে
algebra = বীজগণিত
algorithm = অ্যালগোরিদম
alias = ওরফে
alibi = অজুহাত
alien = বিদেশী লোক
align = সারি দিয়ে সাজান
alignment = অ্যালাইনমেন্ট
alike = একই রকম
alive = জীবন্ত
alkali = ক্ষার
all = সব, সমস্ত
allegation = অভিযোগ
allege = অভিযোগ করা
alleged = অভিযোগে বর্ণিত
alleged = অভিযোগে বর্ণিত
allegiance = আনুগত্ত
allegoric = রূপকাত্মক
allegorical = রূপকাত্মক
allegory = রূপক
allergy = রোগ বিশেষ
alleviate = লাঘব করা
alleviation = উদ্যানে বেড়াইবার পথ
alley = সরু গলি
allied = সন্ধিবদ্ধ
allies = সংযোগ
alliteration = অনুপ্রাস
allocate = বরাদ্দ করা
allocated = বরাদ্দকৃত
allocation = বরাদ্দ করা
allot = বন্টন করা
allotment = বন্টন
allow = অনুমতি দেয়া
allowance = ভাতা
allowed = অনুমোদিত
allows = অনুমোদন করে
alloy = সঙ্কর
allure = আকর্ষণ করা
alluring = লোভনীয়
allusions = পরোক্ষ উল্লেখ
ally = মৈত্রীবদ্ধ ব্যক্তি
almanac = পঞ্জিকা
almighty = সর্বশক্তিমান
almirah = আলমারী
almond = বাদাম
almost = প্রায়
alms = ভিক্ষা
aloe = ঘৃতকুমারী গাছ
aloft = ঊর্ধে
alone = একা
aloneness = একাকীত্ব
along = ধরে
alongside = পাশাপাশি
aloof = কিয়দ্দুরে
aloud = উচ্চ শব্দ করে
alp = গিরিশৃঙ্গ
alpha = আলফা
alphabet = বর্ণমালা
alphabetic = বর্ণানুক্রম
alphabetically = বর্ণানুক্রমিক
already = ইতিমধ্যে
also = ও
altar = বেদী
alter = পরিবর্তন করা
alteration = বদল
altercation = বাদানুবাদ
alternate = বিকল্প
alternately = একান্তরভাবে
alternating = গতিবিমুখ
alternation = পর্যায়ক্রম
alternative = বিকল্প
alternatively = বৈকল্পিকভাবে
although = যদিও
altitude = উচ্চতা
altogether = একবারে
altruist = পরার্থপর ব্যক্তি
alum = ফট্‌কিরি
alumnus = প্রাক্তন ছাত্র
always = সবসময়
am = হই
amalgam = পারদ মিশ্রিত ধাতু
amalgamate = মেশানো
amalgamation = মিশ্রণ
amaryllis = রজনীগন্ধা জাতীয় ফুলের গাছ
amass = সঞ্চয় করা, জমানো
amateur = অপটু
amaze = ভীষণ অবাক
amazed = বিস্মিত
amazing = বিস্ময়কর
ambassador = রাষ্ট্রদূত
amber = পীতাভ বাদামী রং
ambience = বেষ্টনী
ambient = ঘিরে-থাকা, পরিব্যাপ্ত
ambiguity = অস্পষ্টতা
ambiguous = দুর্বোধ্য
ambition = উচ্চাকাঙ্ক্ষা
ambitious = উচ্চাকাঙ্ক্ষী
amble = ধীরেসুস্থে চলা
ambrosia = দেবতাদের খাদ্য
ambulance = অসুস্থ ও আহতদের পরিবহনের গাড়ি
ambush = সৈন্যদের গোপনে অবস্থান
amen = তথাস্তু
amend = শুধরে নেওয়া
amends = ক্ষতিপূরণ
amethyst = বেগুনী বা রক্ত-বেগুনী রঙের বহুমূল্য পাথর
amiability = সৌহার্দ্যপূর্ণতা
amiable = অমায়িক
amicable = বন্ধুত্বপূর্ণ
amid = মধ্যে
ammeter = বিদ্যুপ্রবাহ পরিমাপন যন্ত্র
ammonia = হাইড্রোজেন ত্ত নাইট্রোজেন গ্যাসের মিলনে গ্যাসীয়
ammunition = বোমা, গুলি, বারুদ
amnesia = স্মৃতিশক্তির বিলুপ্তি
amoeba = এককোষী জলজ আণুবীক্ষণিক জীবাণু
among = মধ্যে
amoral = অনৈতিক
amorality = নীতিহীনতা
amount = পরিমাণ
amour = ভালবাসা
ampere = তড়িত্প্রবাহ পরিমাপের একক
amphibian = উভচর প্রাণী
amphibious = উভচর
ample = প্রশস্ত
amplifier = পরিবর্ধক
amplify = বর্ধিত করা
amplitude = বিস্তার, প্রশস্ততা
ampoule = ছোটো কাচের বদ্ধ শিশি যাতে ইনজেকশানের ওষুধ থাকে
amputate = অঙ্গচ্ছেদন করা
amputated = কর্তিত
amputation = অঙ্গচ্ছেদ
amulet = মাদুলি
amuse = মনোরঞ্জন
amused = আমোদিত
amusing = মজাদার
an = এক, একটি
analyser = বিশ্লেষক
anonymous = অজ্ঞাতপরিচয়
anaemia = রক্তাল্পতা
anaesthesia = অচেতন অবস্থা
anaesthetic = অনুভূতিনাশ
anagnorisis = নাটকের চরম পরিণতি
anagram = কোনো শব্দ বা শব্দগুচ্ছের অক্ষরগুলিকে এদিক-ওদিক করে গঠিত শব্দ বা শব্দগুচ্ছ
anal = পায়ু বা মলদ্বার-সম্পর্কিত
analgesia = বেদনার উপশম
analogy = উপমিতি
analyse = বিশ্লেষণ করা
analysis = বিশ্লেষণ
analyst = বিশ্লেষক
analytic = বিশ্লেষণমূলক
analyze = বিশ্লেষণ করা
analyzed = বিশ্লিষ্ট
analyzer = বিশ্লেষক
anarchic = নৈরাজ্যতন্ত্রী
anarchist = নৈরাজ্যবাদী
anarchy = নৈরাজ্য
anathema = গর্হিত কাজ
anatomical = শারীরিক
anatomy = শারীরসংস্থানবিদ্যা
ancestor = পূর্বপুরুষ
anchor = নোঙর
anchovy = হেরিং-জাতীয় ছোট মাছ
ancient = প্রাচীন
and = এবং
anecdote = কোনো ব্যক্তি বা ঘটনাকে কেন্দ্র করে ছোটোখাটো আকর্ষণীয় বা মজার গল্প
anemia = রক্তাল্পতা
anemone = একজাতীয় বনফুল
anew = পুনরায়
angel = দেবদূত
anger = ক্রোধ
angle = কোণ
anglomania = ইংরেজপ্রীতি
angry = রাগান্বিত
anguish = মনোবেদনা
angular =কৌণিক
animal = প্রাণী
animated = প্রাণবন্ত
ankle = গোড়ালি
anklet = নূপুর
annalist = ঐতিহাসিক
annex = গৌণ অংশ হিসেবে যুক্ত করা
annihilate = ধ্বংস করা
annihilated = বিলুপ্ত
anniversary = বার্ষিকী
announce = ঘোষণা করা
announced = ঘোষিত
announcer = ঘোষক
announcing = প্রকাশক
annoy = বিরক্ত করা
annoyed = উত্ত্যক্ত
annoying = বিরক্তিকর
annual = বার্ষিক
annual budget = বার্ষিক বাজেট
annum = বছর
anointment = মলম
anonymity = নামহীনতা
anonymous = নামহীন
another = আরেকটা
answer = সমাধান, উত্তর দেওয়া
ant = পিপীলিকা, পিঁপড়ে
antagonism = প্রতিদ্বন্দ্বিতা
antagonist = বিরোধী
antagonize = শত্রুতা করা
antarctic = দক্ষিণমেরু বা কুমেরু সম্বন্ধীয়
antenna = শুঙ্গ
anterior = সামনের
anthem = প্রশংসাগীতি
anther = পরাগধানী
anthology = সাহিত্যসংকলন
anthropological = নৃতাত্ত্বিক
anthropologist = নৃতত্ববিদ
anthropology = নৃতত্ব
anti = বিরুদ্ধ
anti social = সামাজিক বিরোধী
antibiotic = জীবাণুরোধক
antibody = জীবদেহে কোনো বিশেষ ক্ষতিকর পদার্থ প্রবেশের প্রতিক্রিয়ায় জাত বিশেষ প্রোটিনজাতীয় পদার্থ যা ঐ ক্ষতিকর পদার্থকে ধ্বংস বা নিষ্ক্রিয় করে
anticipate = আশা করা
anticipation = প্রত্যাশা
anticipator = প্রত্যাশাকারী
antidotal = প্রতিষেধক
antidote = বিষনাশক দ্রব্য
antipathy = বিকর্ষণ
antiquarian = প্রত্নতাত্ত্বিক
antique = প্রাচীন
antiquities = পুরাতত্ত্ব
antiquity = প্রাচীনত্ব
antiseptic = জীবাণুমুক্ত
antisocial = সমাজবিরোধী
antithesis = বিরোধিতা
antiviral = ভাইরাস প্রতিরোধী
antler = হরিণ বা হরিণের মতো কয়েকজাতীয় প্রাণীর শিং
antlered = শিংওয়ালা
antonym = বিপরীতার্থক শব্দ
antonymous = বিপরীতার্থক
anus = মলদ্বার
anvil = নেহাই
anxiety = উদ্বেগ
anxious = উদ্বিগ্ন
any = কোনো
anybody = যে কেউ
anyhow = যাই হোক
anymore = আরো
anyone = যে কেউ
anything = যে কোনো কিছু
anyway = যাই হোক না কেন
anywhere = কোথাও
aorta = মহাধমনী
aortal = মহাধমনী - সংক্রান্ত
aortic = মহাধমনীর
apace = দ্রুত
apanage = উপাঙ্গ
aparently = আপাতভাবে
apart = দূরে
apartheid = দক্ষিণ আফ্রিকার বর্ণবৈষম্য নীতি
apartness = বিচ্ছিন্নতা
apathy = অনীহা
ape = বনমানুষ
aperture = ছিদ্র
apex = চূড়া
aphoristic = প্রবচনাত্মক
apiece = প্রতিটি
aplomb = আত্মবিশ্বাস
apocrypha = অপ্রামাণিক
apocryphal = অপ্রামাণিক
apolitical = অরাজনৈতিক
apologist = কোনো কিছুর পক্ষ সমর্থনকারী
apologize = ক্ষমাপ্রার্থনা করা
apology = ক্ষমাপ্রার্থনা
apoplexy = সন্ন্যাসরোগ
apostasy = স্বধর্মত্যাগ
apostle = ধর্ম প্রচারক
app = অ্যাপ্লিকেশন
appal = ভীত
apparent = দৃশ্যমান
apparently = স্পষ্টত
apparition = আকস্মিক আবির্ভাব
appeal = আবেদন করা
appealing = মর্মস্পর্শী
appear = দৃষ্টিগোচর হওয়া, আবির্ভূত হওয়া
appearance = আবির্ভাব
appeared = হাজির
appearing = প্রকাশমান
appease = শান্ত করা
append = সংযোজন
appendicitis = আন্ত্রিক রোগবিশেষ
appendix = পরিশিষ্ট
appetite = ক্ষুধা
appetizer = রুচিকর খাদ্য বা পানীয়
applaud = অনুমোদন জানানো
applause = অনুমোদন
apple = আপেল
appliance = প্রয়োগ
applicability = প্রাসঙ্গিকতা
applicable = প্রাসঙ্গিক
applicant = আবেদনকারী
application = দরখাস্ত
application form = আবেদনপত্র
applied = ফলিত
applique = আবেদন করা
apply = প্রয়োগ করা
applying = প্রয়োজক
appoint = নিযুক্ত করা
appointed = নিযুক্ত
appointment = নিয়োগ
apposite = উপযুক্ত
appraise = মূল্য নির্ধারণ করা
appreciate = সমাদর করা
appreciated = উপলব্ধ
appreciative = প্রশংসাপ্রবণ
apprehend = পাকড়ানো
apprehended = ধরা
apprehensible = বোধগম্য
apprehension = গ্রেপ্তার
apprentice = শিক্ষার্থী
apprise = জানানো
approach = কাছে আসা
approached = তটস্থ
appropriate = উপযুক্ত
appropriately = সঠিকভাবে
appropriator = দখলকারী
approvable = অনুমোদনযোগ্য
approval = সমর্থন
administrative approval = প্রশাসনিক অনুমোদন
approve = সমর্থন বা অনুমোদন করা
approved = অনুমোদিত
approximate = আনুমানিক
approximate value = আনুমানিক মূল্য
approximation = প্রায় সঠিক হিসাব বা সংখ্যা বা পরিমাণ
appurtenance = আনুষঙ্গিক
april = ইংরেজি সনের চতুর্থ মাস
apt = যথাযথ
aptitude = প্রবণতা
aptly = যথাযোগ্যভাবে
aptness = যথোপযুক্ততা
aquarium = মাছের চৌবাচ্চা
aquarius = কুম্ভরাশি
aquatic = জলজ
aquatics = জলক্রীড়া
aqueous = জলীয়
arabic = আরব্য
arbitrary = যুক্তি বা নিয়মবর্হিভূত
arbitration = সালিশি
arc = বৃত্তপরিধির অংশ
arch = বক্ররেখা
arch villain = খলনায়ক
arch enemy = পরম শত্রু
archaeologic = প্রত্নতত্ত্বীয়
archaeological = প্রত্নতাত্ত্বিক
archaeologist = প্রত্নতত্ত্ববিদ
archaic = আদিম
archeology = প্রত্নবিদ্যা
archer = তীরন্দাজ
archery = তীরন্দাজি
archipelago = দ্বীপপুঞ্জ
architect = স্থপতি
architecture = স্থাপত্যকর্ম
archives = কাগজপত্র
archivist = মহাফেজখানার সংরক্ষক
archness = চালাকি
arctic = উত্তরমেরু সংক্রান্ত
ardency = আকুলতা
ardent = উত্তপ্ত
ardently = প্রখরভাবে
arduous = দুঃসাধ্য
area = ক্ষেত্র
arena = মল্লভূমি
argent = রজতশুভ্রতা
argon = নিষ্ক্রিয় গ্যাস
arguable = তর্কসাধ্য
argue = তর্ক করা
argued = বিচারিত
aria = বায়ু
arid = শুষ্ক
aridity = শুষ্কতা
aridness = শুষ্কতা
aright = ঠিক
arise = আবির্ভূত হওয়া
arisen = উদিত
aristocracy = অভিজাততন্ত্র
aristocrat = প্রাচীন বা উচ্চবংশোদ্ভূত ব্যক্তি
aristocratic = সম্ভ্রান্ত
arithmetic = পাটিগণিত
arithmetical = পাটিগণিত সম্বন্ধীয়
arithmetician = পাটিগণিত-বিশারদ
arm = বাহু
armed = অস্ত্রধারী
arming = অস্ত্রশস্ত্র
armor = যুদ্ধোপকরণ
armour = বর্ম
armpit = বগল
arms = অস্ত্র
aroma = বিশেষ ধরনের সৌরভ
aromatic = সুগন্ধযুক্ত
around = চারপাশ
arrack = দেশী মদ
arraign = অভিযুক্ত করা
arraignment = আরোপ
arrange = সঠিকভাবে সাজিয়ে বা গুছিয়ে রাখা
arranged = আয়োজিত
arrangement = সাজানো
array = বিন্যাস
arrest = গ্রেপ্তার
arrival = আগমন
arrive = পৌঁছা
arrogant = অহংকারী
arrow = তীর
arse = গাধা
art = শিল্প
artery = ধমনী
artful = ছলনাময়
artfulness = নিপুণতা
arthritis = বাত
article = প্রবন্ধ
artifact = হস্তনির্মিত বস্তু
artifice = দক্ষতা
artificial = কৃত্রিম
artist = শিল্পী
artistic = শৈল্পিক
artistically = শৈল্পিকভাবে
artists = শিল্পী
as = যেন
ascend = আরোহণ করা
ascendancy = অভ্যুত্থান
ascended = উদিত
ascending = উদীয়মান
asepsis = অপচনশীলতা
aseptic = রোগ-জীবাণুমুক্ত
asexual = অযৌন
asexuality = যৌনপ্রবৃত্তিহীনতা
ash = ভস্ম
ashamed = লজ্জিত
ashen = ধূসরবর্ণ
ashore = তীরে
asian = এশিয়াবাসী
aside from = ব্যতীত
ask = জিজ্ঞাসা করা
asleep = ঘুমন্ত
aspect = দৃশ্যরূপ
aspirant = উচ্চাভিলাষী
aspiration = আকাঙ্ক্ষা
aspire = উচ্চাভিলাষী বা আকাঙ্ক্ষিত হওয়া
aspirin = বেদনা শির:পীড়া প্রভৃতির ঔষধবিশেষ
aspiring = উচ্চাকাঙ্ক্ষী
asquint = ট্যারাচোখে
ass = গাধা
assail = তীব্র আক্রমণ করা
assailable = আক্রমণসাধ্য
assassin = গুপ্তঘাতক
assault = শারীরিক আক্রমণ
assay = মূল্যবান ধাতুর বিশুদ্ধতা যাচাই
assemblage = ব্যক্তি বা বস্তুর সমাবেশ
assemble = একত্রিত করা
assembled = সমবেত
assembly = সভা
assert = সোজাসুজি বলা
asserted = জাহির
assess = ধার্য করা
assessable = নির্ধার্য
assessing = পরিমাপন
asset = ধনসম্পত্তি
assets = সম্পত্তি
assiduity = একাগ্রতা
assiduous = পরিশ্রমী
assignable = হস্তান্তরযোগ্য
assignation = আদেশ
assigned = আরোপিত
assigning = আরোপক
assimilation = আত্তীকরণ
assist = সহযোগিতা করা
associate = সহকারী
associate professor = সহযোগী অধ্যাপক
associate law = সহযোগী আইন
associated = সংযুক্ত
associating = দোসর
association = সমিতি
assuage = হ্রাস করা
assume = রূপ গ্রহণ করা
assurance = নিশ্চয়করণ
assure = আশ্বাস দেওয়া
assured = নিশ্চিত
assuredly = নিশ্চয়
aster = হলুদ কেন্দ্রের চারদিকে সাদা
asterisk = তারকাচিহ্ন
astern = জাহাজের বা বিমানের পশ্চাদভাগে
asteroid = গ্রহাণু
asthenia = দুর্বলতা
asthma = শ্বাসকষ্ট
asthmatic = হাঁপানিগ্রস্ত
astir = চলন্ত অবস্থায়
astonished = বিস্মিত
astonishing = বিস্ময়কর
astound = স্তম্ভিত করা
astounded = স্তম্ভিত
astounding = স্তম্ভিত করে এমন
astray = বিপথগামী
astrologer = জ্যোতিষী
astrological = জ্যোতিষশাস্ত্র সংক্রান্ত
astrology = জ্যোতিষশাস্ত্র
astronaut = নভোচর
astronomer = জ্যোতির্বিদ
astronomical = জ্যোতির্বিদ্যা সংক্রান্ত
astronomy = জ্যোতির্বিজ্ঞান
astrophysicist = জ্যোতিঃপদার্থবিজ্ঞানী
astrophysics = জ্যোতিঃপদার্থবিজ্ঞান
astute = তীক্ষ্ণবুদ্ধি
asymmetrical = অপ্রতিসম
at = প্রতি
atheism = নাস্তিকতা
atheist = নাস্তিক
atheistic = নাস্তিকতা সম্বন্ধীয়
athlete = প্রতিযোগী
athletic = ক্রীড়াবিষয়ক
athletics = শরীরচর্চা
atlas = মানচিত্র
atmosphere = আবহমণ্ডল, বায়ুমণ্ডল
atmospheric = বায়ুমণ্ডলীয়
atom = পরমাণু
atomic = পরমাণুসংক্রান্ত
atonal = বেসুরো
atone = প্রতিকার বা প্রতিবিধান করা
atop = ওপরে
atrocious = নির্মম
atrociously = নৃশংসভাবে
atrociousness = নিদারুণ নিষ্ঠুরতা
atrophied = দুর্বল
atrophy = ক্রমিক ক্ষয়প্রাপ্তি
attach = সংশ্লিষ্ট করা
attached = সংযুক্ত
attack = আক্রমণ করা
attacked = আক্রান্ত
attacker = আক্রমণকারী
attain = চেষ্টা করে কোনো কিছু লাভ করা
attainable = অধিগম্য
attar = আতর
attempt = প্রয়াস
attend = কোনো কিছুতে মনঃসংযোগ করা
attendance = উপস্থিতি
attendance register = হাজিরা
attendant = পরিচালক
attended = নিষেবিত
attention = মনোযোগ
attentive = একাগ্রচিত্ত
attentively = অনন্যচিত্তে
attenuated = ক্ষয়িত
attest = সত্য বলে ঘোষণা করা
attestation = প্রত্যয়ন
attested = প্রত্যায়তি
attic = চিলেকোঠা
attire = পোশাক
attorney = আইনজীবী
attract = আকর্ষণ করা
attracted = আকৃষ্ট
attraction = আকর্ষণ
attractive = চিত্তাকর্ষক
attributable = আরোপ্য
attribute = কোনো ব্যক্তি বা বস্তুর বিশেষ গুণ
attributes = বৈশিষ্ট্যাবলী
attributive = গুণবাচক
attrition = ঘর্ষণজনিত ক্ষয়
atypical = অস্বাভাবিক
auction = নিলাম
audacious = দুঃসাহসী
audacity = দুঃসাহস
audibility = শ্রবণযোগ্যতা
audible = শ্রাব্য
audience = শ্রোতাবৃন্দ, দর্শকবৃন্দ
audio = শব্দ
audit = আয়ব্যয়ের বিবরণ
audited = নিরীক্ষিত
auditing = নিরীক্ষক
audition = গুণপরীক্ষা
auditor = নিরীক্ষক
auditorium = প্রেক্ষাগৃহ
auditory = শ্রবণ-সংক্রান্ত
augment = বর্ধিত করা
augmented = উদ্দীপিত
augmenting = উদ্দীপক
augur = ভবিষ্যদ্বাণী করা
aunt = পিসিমা, মাসিমা, জেঠিমা, মামিমা
aunty = আন্টি
aura = সুরভিতরঙ্গ
aurora = রোমানদের উপাস্য ঊষাদেবী
aurora borealis = সুমেরুপ্রভা, সুমেরুজ্যোতি
auspices = পৃষ্ঠপোষকতা
auspicious = শুভ
austerity = সন্ন্যাস
autarchy = স্বৈরতন্ত্র
authentic = অকৃত্রিম
authenticate = সত্য বা খাঁটি বলে প্রমাণ করা
authentication = প্রমাণীকরণ
authenticity = সত্যতা
author = লেখক
authority = কর্তৃপক্ষ
authorization = প্রাপ্তাধিকার
authorize = অনুমোদন  করা
authorized = অনুমোদিত
autism = বহির্বিমুখিতা
autistic = অটিস্টিক
authors = লেখক
auto = স্বয়ংক্রিয়
autobiographical = আত্মজীবনীমূলক
autobiography = আত্নজীবনী
autocracy = স্বৈরাচার
autocrat = স্বৈরাচারী শাসক
autocratic = স্বৈরাচারী
autodetect = সয়ংক্রিয়ভাবে সনাক্ত করা
autograph = কোনো ব্যক্তির নিজ হস্তাক্ষর
automate = স্বয়ংচল কর
automatic = স্বয়ংক্রিয়
automatically = সয়ংক্রিয়ভাবে
automobile = মোটরগাড়ি
automobiles = মোটরগাড়ি
automotive = যন্ত্রচালিত
autonomous = স্বশাসিত
autonomy = স্বশাসন
autopsy = শবদেহ পরীক্ষা
autoselect = স্বয়ংক্রিয় নির্বাচন
autostrada = রাজপথ
autumn = শরত্‍কাল
auxiliary = সাহায্যকারী
availability = সুবিধা
available = লভ্য
avalanche = হিমবাহ
avarice = অর্থলালসা
avast = থামো
avatar = অবতার
avenge = প্রতিশোধ নেওয়া
avenged = প্রতিকৃত
avenue = রাজপথ
average = গড়
aversion = অনীহা
avert = এড়ানো
aviary = পক্ষিশালা
aviation = বিমান চলাচল
avid = আগ্রহী
avidly = লুব্ধভাবে
avocation = পেশা
avoid = এড়িয়ে চলা
avoid = এড়িয়ে চলা
avoidance = এড়ানো
await = অপেক্ষা করা
awaited = প্রতীক্ষিত
awaiting = প্রতীক্ষমাণ
awake = ঘুম ভাঙা
awaken = ঘুম ভাঙা
awakened = জাগরিত
awakening = জাগরণ
award = পূরস্কার, প্রদান করা
aware = অবগত
awareness = অবগতি
awash = প্লাবিত
away = দূরে
awe = সমীহ
aweary = ক্লান্ত
awful = ভয়াবহ
awhile = কিছুক্ষণের জন্য
awkward = উদ্ভট
axe = কুড়ুল
axiom = প্রতিপাদ্য
axis = অক্ষরেখা
azure = উজ্জ্বল নীল রং
babbling = অস্ফুটবাক্
babe = শিশু
baby = শিশু
bachelor = অবিবাহিত পুরুষ
back = পিছনদিক
background = প্রেক্ষাপট
backward = অনগ্রসর
bad = খারাপ
baffle = দ্বিধাগ্রস্ত
bag = ব্যাগ
bail = জামিন
bait = টোপ
bakery = বেকারি
balance = ভারসাম্য
balanced = সমানুপাতিক
balcony = অলিন্দ
bald = কেশশূন্য
bale = অনিষ্ট
ball = বল
ballad = চারনগীতি
ballistic missile = ক্ষেপণাস্ত্র
balloon = বেলুন
ballot = ভোটপত্র
bamboo = বাঁশ
ban = নিষিদ্ধ করা
banana = কলা
bandit = দস্যু
bane = সর্বনাশ
banian = বটগাছ
banish = নির্বাসিত করা
bank = ব্যাংক
banking = ব্যাঙ্কের কাজকারবার
bankrupt = দেউলিয়া
banner = পতাকা
banter = ঠাট্টা
banyan = বট গাছ
baptize = খ্রিষ্টধর্মে দীক্ষিত করা
bar = কাঠ
barbarian = বর্বর
barber = নাপিত
bard = চারণ
bare = অনাবৃত
bargain = দর কষাকষি
bargee = নাবিক
bark = গাছের ছাল
barking = ঘেউ ঘেউ খেঁক কুকুরের ডাক
barley = যব
barrack = সেনানিবাস
barrel = পিপে
barren = বন্ধ্যা
barrenness = অনুর্বরতা
barricade = অবরোধ
barrier = প্রতিবন্ধক
barrow = স্তূপ
base = ভিত্তি
bash = সজোড়ে আঘাত করা
bashful = লাজুক
bashfulness = ভীরুতা
basic = প্রাথমিক
basil = পুদিনাজাতীয় গুল্ম
basis = ভিত্তি
bask = আগুন বা রোদ পোহানো
basket = ঝুড়ি
bastard = জারজ সন্তান
batch = দল
bath = স্নান
bathe = অবগাহন
bat = বাদুড়
battery = ব্যাটারি
batting = ব্যাটিং
battle = সংগ্রাম
bawl = গলা ফাটিয়ে কাঁদা
bay = উপসাগর
bazar = বাজার
be = হত্তয়া
beach = তটভূমি
beacon = সংকেত
bead = গুটিকা
beads = জপমালা
beak = চঞ্চু
beam = আলোকরশ্মি
bean = মটরশুটি
bear = ভালুক
bearable = বহনীয়
beard = দাড়ি
bearer = বাহক
beast = জন্তু
beat = আঘাত করা
beau = পোশাকপরিচ্ছদে শৌখিন ব্যক্তি
beautician = রূপবিশারদ
beautiful = সুন্দর
beautify = সৌন্দর্য করা
beauty = সৌন্দর্য
because = কারণ
beck = অর্থবহ ইশারা
become = হয়ে ওঠা
bed = বিছানা
bee = মৌমাছি
beef = গোমাংস
been = হয়েছে
beetle = গূবরেপোকা
before = আগে
befriend = বন্ধুত্ব স্থাপন করা
beg = ভিক্ষা করা
beget = জন্ম দেওয়া
beggar = ভিক্ষুক
begging = ভিক্ষাবৃত্তি
begin = আরম্ভ করা
beguile = ছলনা করা
begun = উপক্রান্ত
behalf = কারো তরফে
behave = আচরণ
behaviour = চালচলন
behead = শিরচ্ছেদ করা
beheading = শিরশ্ছেদ
behind = পশ্চাতে
behold = চেয়ে দেখ
being = অস্তিত্ব
belfry = গির্জার ঘন্টাঘর
believe = বিশ্বাস হওয়া
belike = সম্ভবত
belly = উদর
belong = কারো অধিকারভুক্ত হওয়া
beloved = অত্যন্ত প্রিয়
below = নিচে
belt = কোমরবন্ধ
bench = কাঠের বা পাথরের তৈরি লম্বা আসন
bend = নুয়ে পড়া
beneath = তলায়
benedictory = আশীর্বাদসূচক
benefactor = উপকারী ব্যক্তি
beneficial = সুবিধাজনক
beneficiary = লাভবান
benefit = ফয়দা
benevolent = দানশীল
bengali = বাংলা
benign = অমায়িক
berate = তীব্র ভর্ৎসনা করা
bereave = বঞ্চিত করা
berg = পর্বত
beset = পরিবৃত করা
beside = পাশে
best = সেরা
bestow = অর্পণ করা
bet = বাজি রাখা
betel = পান
betray = বিশ্বাসঘাতকতা করা
betroth = বাগদান করা
better = শ্রেষ্ঠতর
between = মধ্যিখানে
beware = হুঁশিয়ার
bewilder = কিংকর্তব্যবিমূঢ়
bewitch = মন্ত্রমুগ্ধ করা
bey = বাবু
beyond = অপর পার্শ্বে
bias = প্রবণতা
biased = পক্ষপাতমূলক
bible = খ্রিস্টানদের পবিত্র ধর্মগ্রন্থ
bibliophile = পুস্তকপ্রেমিক
bicycle = সাইকেল
bid = নির্দিষ্ট পরিমাণ দাম দিতে চাওয়া
bidder = যে নিকাম ডাকে
bide = অবস্থান করা
big = বিরাট
bigger = 
bigamy = দ্বিপত্নীকরণ
biggest = বৃহত্তম
bike = মোটর সাইকেল
bile = পিত্ত
bill = টাকার হিসাব
bin = আবর্জনা জড়ো করে রাখার পাত্র
binary = দ্বৈত
bind = বাঁধা
bioscope = সিনেমার আদি নাম
biosphere = জীবমণ্ডল
bird = পাখি
birth = জন্ম
birth control = জন্মনিয়ন্ত্রণ
birth certificate = জন্ম সনদ
biscuit = বিস্কুট
bisect = দুভাগে ভাগ করা
bisection = দ্বিখণ্ডন
bishop = খ্রিস্টীয় ধর্মাধ্যক্ষ
bit = কামড়
bite = কামড়ানো
bitten = দংশিত
bitter = তিক্ত
black = কালো
black hole = কৃষ্ণ গহ্বর
blackening = কৃষ্ণতা
blackish = কালচে
blackness = অন্ধকার
bladder = মূত্রাশয়
blade = ছুরি
blah = অর্থহীন বাগাড়ম্বর
blame = দোষারোপ করা
blank = ফাঁকা
blanket = কম্বল
blast = বিস্ফোরক
blaze = উজ্জ্বল অগ্নিশিখা
blazer = জ্যাকেট
bleach = জীবাণুনাশক
bleaching = ধোলাই
bleed = রক্ত পড়া
bleeding = রক্তপাত
blend = মিশ্রিত করা
bless = আশীর্বাদ করা
blessed = সুখী
blessing = বর
blind = অন্ধ
blindfold = চোখের ঠুলি
blindness = অন্ধত্ব
blink = চোখ পিটপিট করা
bliss = পরম সুখ
blissful = পরম সুখী
blither = আবোল - তাবোল
blitz = আকস্মিক প্রচণ্ড আক্রমণ
blizzard = তুষারঝড়
block = কাঠপাথর
blockade = কোনো স্থানকে অবরোধ
bloke = আদমি
blond = স্বর্ণকেশী ব্যক্তি
blonde = ফর্সা স্ত্রীলোক
blood = রক্ত
bloody = রক্তাক্ত
bloom = প্রস্ফুটিত
blossom = মুকুল
blossoming = অঙ্কুরোদ্গম
blot = কালি দাগ
blow = প্রবাহিত হওয়া
blown = প্রস্ফুটিত
blowy = বায়ুতাড়িত
blue = নীল
blunder = গুরুতর ভুল করা
blunt = ভোঁতা
blur = অস্পষ্টতা
blush = লজ্জারুণ হওয়া
bluster = প্রবলবেগে প্রবাহিত হওয়া
boar = বনশুয়োর
board = কাঠের তক্তা
boat = নৌক
bob = মেয়েদের চুল ঘাড় পর্যন্ত ছেঁটে দেওয়া
bode = পূর্বাভাস দেওয়া
body = দেহ
bog = ভিজে নরম মাটি
bogus = মিথ্যা
boil = টগবগ করে ফোটা
bold = সাহসী
bolt = বজ্র
bomb = বোমা
bond =
bone = অস্থি
bonus = উপরিলাভ
book = বই
boon = অনুগ্রহ
boor = গেঁয়ো ভূত
boot = বুট জুতো
booth = স্টল
border = প্রান্ত
bore = খনন করা
bored = বিষণ্ণ
boring = বিরক্তিকর
born = জাত
borne = জন্ম দেত্তয়া
borrow = ধার নেওয়া
boss = কর্মকর্তা
botanical = উদ্ভিদ্বিদ্যাসংক্রান্ত
botanist = উদ্ভিদ্বিজ্ঞানী
botany = উদ্ভিদবিদ্যা
both = উভয়
bother = দুশ্চিন্তায় ফেলা
bottle = বোতল
bottom = তলদেশ
bought = কেনা
bounce = লাফিয়ে ওঠা
bound = সীমা
boundary = সীমারেখা
bouquet = ফুলের তোড়া
bourn = সীমানা
bout = পালা
boutique = হালফ্যাশানের প্রসাধনসামগ্রীর দোকান
bow = ধনুক, নত হইয়া অভিবাদন
bowl = বাটি
bowman = তীরন্দাজ
box = বাক্স = ঘেরা জায়গা = ছাউনি = বক্সিং লড়া
boxing = মুষ্টিযুদ্ধ্
boy = ছেলে, বালক
boycott = অসহযোগ
boyhood = বাল্যকাল
bra = স্ত্রীলোকের বক্ষবন্ধনী
brace = বন্ধনী
bracelet = বালা
brag = গর্ব করা
braid = বিনুনি
braille = অন্ধ ব্যক্তিদের জন্য বিশেষ ধরনের লিখন বা মুদ্রণ পদ্ধতি
brain = মস্তিষ্ক
brake = ব্রেক
bran = তুষ
branch = বৃক্ষশাখা
brand = নির্দিষ্ট ব্যবসায়িক ছাপ
brand new = একদম নতুন
branded = দাগী
brandy = এক ধরনের কড়া মদ
brass = পিতল
brat = ছোঁড়া
bravado = বাহাদুরি
brave = সাহসী
brawl = ঝগড়া
brawn = শক্তি
breach = খেলাপ
bread = পাউরুটি
breadth = প্রস্থ
break = ভাঙ্গন
breakfast = প্রাতরাশ
breast = স্তন
breath = দম, শ্বাস
breathe = শ্বাস গ্রহণ ও ত্যাগ করা
bred = পালিত
breed = বংশবৃদ্ধি করা
breeze = মৃদুমন্দ বাতাস
brethren = ভ্রাতৃবৃন্দ
brew = পাতা ভিজিয়ে বা ফুটিয়ে পানীয় বানানো
bribe = ঘুষ
brick = ইট
bride = নববধূ
bridge = সেতু
brief = সংক্ষিপ্ত
briefing = নির্দেশ
briefly = সংক্ষেপে
bright = উজ্জ্বল
briliant = মেধাবী
brim = কাপ
bring = আনা
brink = প্রান্ত
broad = চওড়া
broadcast = সম্প্রচার করা
broadways = আড়াআড়িভাবে
brochure = প্রচারপত্র, ইস্তাহার
broke = সর্বস্বান্ত
broken = ভাঙা
broker = দালাল
bromine = ব্রোমিন
bronchi = শ্বাসনালিদ্বয়
bronze = তামা ও টিনের সংকর-ধাতু
brothel = বেশ্যালয়
brother = ভ্রাতা
brown = বাদামী
browse = ঘাঁটা
bruise = চোট
brunch = দুপুরের খাওয়া এবং প্রাতরাশের বদলে একবারই বেলা করে খাওযা
brush = ঝাড়া
brutal = বর্বরোচিত
brute = নিষ্ঠুর
bubble = বুদ্বুদ
bubbly = বুদ্বুদপূর্ণ
buccaneer = জলদস্যু
buck = খরগোশ
bucket = বালতি
buckle = ধাতু
bud = মুকুল
buddhism = বৌদ্ধধর্ম
buddhist = বৌদ্ধধর্মাবলম্বী
buddy = সঙ্গী
budge = অতি সামান্য সরানো
budget = বাজেট
buff = মনুষ্য-ত্বক
buffalo = মোষ
buffer = অপদার্থ লোক
buffet = স্ব-পরিবেশন কাউন্টার
buffoon = ভাঁড়
bug = ছারপোকা
bugle = রণশিঙা
build = নির্মাণ করা
building = কাঠামো
built = নির্মিত
bulb =
bulbul = বুলবুল
bulge = স্ফীতি
bulk = পরিসর
bulkhead = জাহাজের মধ্যে জলরোধক বেষ্টনী
bull = ষাঁড়
bullet = বন্দুকের গুলি
bullet proof = বুলেট প্রুফ
bulletin = সরকারি সংবাদ-বিবৃতি
bullion = সোনা বা রুপোর বাট
bullion market = সোনা বা রুপার বাজারে
bullock = বলদ
bullock cart = গরুর গাড়ি, গোযান
bullshit = বাজে কথা
bully = মস্তান
bum = পাছা
bump = ধাক্কা
bumper = সুপ্রচুর
bumpkin = অমার্জিত ব্যক্তি
bun = ছোটো গোলাকৃতি মিস্টি কেক
bunch = গুচ্ছ
bungalow = একতলা ছোটো বাড়ি
bungling = অনৈপুণ্য
bunk =
bunker =
bunny = খরগোশ
buoy = নোঙর করা ভাসমান বস্তু
buoyancy = প্লবতা
burden = ভার
burg = শহর
burglary = সিঁধ কেটে চুরি
burgle = সিঁধ কেটে ঢোকা
burial = কবর
burlap = ব্যাগ
burner = দহনকারী
burning = জ্বলন্ত
burning ground = শ্মশান
burning glass = আতশী কাচ
burnish = পালিশ তোলা
burnt = অগ্নিদগ্ধ
burp = ঢেঁকুর
bursar = কোষাধ্যক্ষ
burst = বিস্ফোরিত হওয়া
bus = বাস
bush = ঝোপ
busily = ব্যস্ততাসহকারে
business = কেনাবেচা
busy = ব্যস্ত
but = কিন্তু
butcher = কসাই
butler = প্রধান পরিচালক
butter = মাখন
butterfly = প্রজাপতি
buttock = পাছা
button = বোতাম
buy = কেনা
buzz = গুনগুন করা
bye =
bygone = অতীত
bylaw = উপবিধি স্থানীয় ব্যবস্থা
byproduct = উপজাত
bystander = দর্শক
byte = তথ্যের একক
byword = জনশ্রুতি
cabbage = বাঁধাকপি
cable = কেবল
cables = কেবল
cache = ক্যাশ
cafe = রেস্তরাঁ
cage = খাঁচা
cake = কেক
calculable = গণনযোগ্য
calculate = গণনা
calculated = গণনাকৃত
calculating = গণনা করছে
calculation = গণনা
calculator = ক্যালকুলেটর
calculus = পাথুরি রোগ
calendar = বর্ষপঞ্জি
calibration = পরিমাপ নির্দিষ্ট-করণ
call = ডাক দেওয়া
caller = আহ্বায়ক
calm = শান্ত
camel = ঊট
cameras = ক্যামেরা
camouflage = ধুলো দেওয়া
camp = শিবির
campaign = সংগঠিত প্রচারকার্য
camps = শিবিরগুলি
campus = ক্যাম্পাস
can = করতে পার
canal = খাল
canals = খাল
cancel = বাতিল
canceled = বাতিলকৃত
cancellation = বাতিল
cancer = ক্যান্সার
candidate = প্রার্থী
cannot = গেল না
canvas = চিত্রপট
canyon = গিরিখাত
cap = টুপি
capabilities = সক্ষমতা
capability = সক্ষমতা
capable = সক্ষম
capacious = প্রশস্ত
capacities = ধারনক্ষমতা
capacitor = ধারক
capacity = ক্ষমতা
capita = মাথাপিছু
capital = রাজধানী
capitalism = পুঁজিবাদ
capitalist = পুঁজিপতি
capsicum = লঙ্কা
captain = অধিনায়ক
caption = শিরোনাম
capture = অধিগ্রহণ করা
car = গাড়ি
card = কার্ড
cardamom = এলাচ
cardboard = কার্ডবোর্ড
cards = তাস
care = যত্ন
career = জীবিকা
carefully = যত্নসহকারে
caretaker = তত্ত্বাবধায়ক
cargo = মাল
carnage = হত্যাকান্ড
carnival = মহোৎসব
carpenter = ছুতোর
carriage = বাহন
carried = বহন করা
carrier = বাহক
carrot = গাজর
carry = বহন করা
cartridge = কার্তুজ
carver = মাংস-কাটা ছুরি
carving = খোদাই করা কোন জিনিস
cascade = জলপ্রপাত
case = ক্ষেত্র
cases = ঘটনা
cash = নগদ
cashier = কোষাধ্যক্ষ
cask = তরল জিনিস রাখিবার পিপা
casket = মণি-রত্নাদি রাখিবার ছোট বাক্স
cassette = ক্যাসেট
cassettes = ক্যাসেট
cassocked = আলখিল্লা পরিহিত
cast = নিক্ষেপ করা
caste = যবর্ণ
castigate = প্রহার করা
castigation = ভর্ৎসনা
casting = নিক্ষেপণ
castle = দুর্গ
casual = অসতর্ক
casually = দৈবাৎ
casualty = দুর্ঘটনা
cat = বিড়াল
catalog = সুবিন্যস্ত তালিকা
catalogue = তালিকা
catalyst = অনুঘটক
catapult = প্রাচীনযুগের পাথর ছুড়িবার যন্ত্র
cataract = জলপ্রপাত
catastrophe = চরম বিপর্যয়
catastrophic = সর্বনাশা
catch = ধরা
catching = সংক্রামক
catchy = চিত্তাকর্ষক
catechism = প্রশ্নোত্তর দ্বারা শিক্ষাদান
categorical = বিভাগীয়
categories = শ্রেণীবিভাগ
categorize = শ্রেনীবিভাগ করা
category = শ্রেণীবিভাগ
cater = পরিবেশন
catered = পরিবেশিত
caterpillar = শুঁয়োপোকা
cathedral = বিশপের অধীন গির্জা
catheter = মূত্র নিষ্কাশনের নল বিশেষ
cathode = ক্যাথোড
cattle = গবাদি পশু
cattle = গৃহপালিত পশু
cauliflower = ফুলকপি
cause = কারণ
caused = ঘটায়
causeway = পাথরে বাঁধানো উঁচু রাস্তা
cauterize = উত্তপ্ত শলাকা দ্বারা পোড়ান
caution = সতর্কতা
caution = সতর্ক করা
cautious = সতর্ক
cavalier = অশ্বারোহী সৈনিক
cave = গুহা
cavity = গহ্বর
cease = বিরত থাকা
ceasefire = যুদ্ধবিরতি
ceaseless = অবিরাম
ceiling = ঘরের ছাদের ভিতরের দিক
celebrate = উদযাপন
celebration = উদযাপন
celebrity = বিখ্যাত ব্যক্তি
celerity = বেগ
celestial = স্বর্গীয়
cell = কক্ষ
cellophane = সেলোফেন
cellular = কোষবিশিষ্ট
cellulose = সেলুলোজ
cement = সিমেন্ট
cemetery = সমাধিস্থল
censorship = বাধানিষেধ
census = জনগণনা
cent = শত
center = কেন্দ্র
centimeters = সেন্টিমিটার
central = কেন্দ্রীয়
centre = কেন্দ্র
centric = কেন্দ্রিক
century = শতাব্দী
cereal = খাদ্যশস্য
ceremonial = আনুষ্ঠানিক
ceremonially = আনুষ্ঠানিকভাবে
ceremony = উৎসব
certain = কতগুলি
certainly = নিশ্চিতভাবে
certificate = শংসাপত্র
certificates = সনদপত্র
certification = সত্যতা অনুমোদন
certify = শংসাপত্র দেওয়া
chagrin = হতাশা
chain = শৃঙ্খল
chair = কেদারা
chairman = সভাপতি
challenge = প্রতিদ্বন্দ্বিতা
challenging = প্রতিদ্বন্দ্বিতাপূর্ণ
chamber = কক্ষ
champagne = শ্যাম্পেন
champion = বিজয়ী
chance = ভাগ্যক্রমে ঘটে এমন
chance = সুযোগ
change = পরিবর্তন
changed = পরিবর্তিত
changes = পরিবর্তন
changing = পরিবর্তনশীল
channel = চ্যানেল
channels = চ্যানেল
chapter = অধ্যায়
chapters = পরিচ্ছেদ
char = অক্ষর
character = অক্ষর
characteristic = বৈশিষ্ট্য
characteristically = বৈশিষ্টময়ভাবে
characteristics = গুণাবলিসমূহ
characterization = বৈশিষ্ট্য
characterize = বৈশিষ্ট্য বর্ণনা করা
characters = অক্ষর
charcoal = চারকোল
charge = আধান
charge = আধানযুক্ত করা
charged = আধানযুক্ত
chariot = রথ
charitable = পরহিতকর
charm = আকর্ষণ শক্তি
chart = তালিকা
charter = ফরমান
chastity = সতীত্ব
chat = আড্ডা
chat = চ্যাট
cheap = সস্তা
cheat = প্রতারণা করা
check = পরীক্ষা করা
checked = পরীক্ষিত
checker = পরীক্ষক
checking = পরীক্ষা করা
checking = পরীক্ষা করছে
cheek = গাল
cheer = উল্লাস
cheerful = আনন্দময়
cheerfulness = আনন্দ
cheers = হর্ষোল্লাস
chemical = রাসায়নিক
chemise = মহিলাদের লম্বা ঢিলেঢালা অন্তর্বাস বিশেষ
chemist = রসায়নবিদ
chemistry = রসায়ন
chess = দাবা
chew = চর্বণ করা
chew = চিবিয়ে খাওয়া
chewing = চিবানো
chicken = মুরগি
chicly = সৌনাভ
chief = মুখ্য
chieftain = দলনেতা
chignon = গুছি
child = চাইল্ড
childish = ছেলেমি
children = শিশু
chili = মরিচ
chip = চীপ
chirpy = হাসিখুশী
chloride = ক্লোরাইড
choice = পছন্দ
choices = পছন্দ
choir = গির্জার গায়কদল
choke = কন্ঠরোধ করা, শ্বাসরোধ করা
cholera = কলেরা
choose = বেছে নিন
chop = টুকরো টুকরো করে কাটা
chord = বাদ্যযন্ত্রের তার
chorus = গায়কদল
chosen = নির্বাচিত
christen = নামকরণ করা
chronicle = ধারাবিবরণী
chuckle = খিকখিক করে হাসি
chum = অন্তরঙ্গ বন্ধু
chutney = আচার
cigar = চুরুট
cigarette = সিগারেট
cinema = সিনেমা
circle = বৃত্ত
circuit = সার্কিট
circular = বৃত্তাকার
circulate = প্রদক্ষিণ করা
circumpolar = মেরু পরিবৃত্ত
circumstance = পরিস্থিতি
circumstances = পরিস্থিতি
circumvention = বোকা বানান
circus = সার্কাস
citation = উদ্ধৃতি
cite = উদ্ধৃতি দেওয়া
cities = নগরী
citizen = নাগরিক
city = শহর
citywide = নগরব্যপী
civic = নাগরিক
civil = অসামরিক
civilian = অসামরিক ব্যাক্তি
civilization = সভ্যতা
claim = দাবী
claim = দাবী করা
clarity = স্পষ্টতা
clash = সঙ্ঘর্ষ
clashes = সঙ্ঘর্ষ
class = শ্রেনী
classes = শ্রেণী
classic = ক্লাসিক
classical = সনাতন
classically = সনাতনভাবে
classification = শ্রেণীবিভাগ
classified = শ্রেণীকৃত
classify = শ্রেণীভুক্ত করা
classmate = সহপাঠী
clay = কাদা
clean = পরিষ্কার
clean = পরিচ্ছন্ন
clean = পরিষ্কার করা
cleaner = বেশি পরিষ্কার
cleaning = পরিষ্কার
cleanly = পরিচ্ছন্নভাবে
cleanse = সাফ করা
cleanup = পরিষ্কার
cleanups = পরিষ্কার
clear = পরিষ্কার
clear = মুছে ফেলো
clearly = স্পষ্টভাবে
clerk = করণীক
clever = চতুর
click = ক্লিক
clicking = ক্লিক করা হলে
client = গ্রাহক
clients = ক্লায়েন্ট
climate = জলবায়ু
climb = আরোহণ করা
clinic = ক্লিনিক
clinical = চিকিৎসার জন্য
clip = ক্লিপ
clipboard = ক্লীপবোর্ড
clock = ঘড়ি
clockwise = ডানাবর্তী
clog = অবরোধ করা
clone = ক্লোন
cloning = ক্লোনিং
close = নিকট, বন্ধ করা
closed = বন্ধ
closer = নিকটতর
closer = আরো কাছে
closing = সমাপ্তি
closure = বন্ধ
clot = জমাট বাঁধা
cloth = জামাকাপড়
clothe = পোষাক
clothes = পোষাক সমূহ
clothing = পোশাক
cloud = মেঘ
clove = লবঙ্গ
club = ক্লাব
clue = সূত্র
cluster = গুচ্ছ
cm = সেঃ মিঃ
coach = কামরা
coaches = কামরা
coaching = কোচিং
coal = কয়লা
coalesce = একাত্ম হওয়া
coalition = জোট
coast = উপকূল
coastal = উপকূলবর্তী
coastline = উপকূলরেখা
coated = প্রলেপ দেওয়া
cobra = গোখরো সাপ
cocaine = কোকেন
cock = মোরগ
cockroach = তেলাপোকা
coconut = নারকেল
code = কোড
coding = কোডিং
coexist = সহাবস্থান করা
coffee = কফি
cogently = দৃঢ়ভাবে
coin = মুদ্রা
coincide = সামঞ্জস্যপূর্ণ হওয়া
coincidence = দৈবঘটনা
cold = শীতল
coldly = ঠান্ডাভাবে
collaboration = সহযোগিতা করা
collage = কোলাজ
collapse = ভেঙ্গে পড়া
collapse = ভেঙে পড়া
colleague = সহকর্মী
collect = সংগ্রহ করা
collecting = সংগ্রহকরণ
collection = সংগ্রহ
collective = সম্মিলিত
collectively = সামগ্রিকভাবে
college = মহাবিদ্যালয়
colleges = মহাবিদ্যালয়
collision = সংঘর্ষ
colon = কোলন
colonial = ঔপনিবেশিক
colonies = উপনিবেশ
colony = উপনিবেশ
color = রং
colored = রঙীন
colors = রং
coloured = রঙীন
column = কলাম
columns = কলাম
coma = কোমা
comb = চিরুনি
combination = সম্মিলন
combinations = বিন্যাস
combined = সম্মিলিত
come = আসা
comedian = ভাঁড়
comedy = কৌতুক
comes = আসে
comet = ধূমকেতু
comfort = আরাম
comfortable = আরামদায়ক
coming = আসছে
comma = কমা
command = কমান্ড
commas = কমা
commemorate = স্মরনীয় করে রাখা
comment = মন্তব্য করা
comments = মন্তব্য
commerce = বাণিজ্য
commercial = বাণিজ্যিক
commercially = বাণিজ্যিকভাবে
commerical = বাণিজ্যিক
commissar = কমিসার
commissioner = কমিশনার
committee = কমিটি
committees = কমিটি
commodity = পণ্য
common = সাধারণ
commonsense = সাধারণ জ্ঞান
commonly = সাধারণভাবে
commons = কমনস
commonwealth = কমনওয়েলথ
communal = সাম্প্রদায়িক
communicate = যোগাযোগ করা
communication = যোগাযোগ
communications = যোগাযোগ
communicative = আলাপী
communism = বামপন্থা
communist = কম্যুনিষ্ট
communities = সম্প্রদায়
community = সম্প্রদায়
compact = নিবিড়
companies = কোম্পানি
companion = সহচর
company = কোম্পানি
compare = তুলনা করা
comparison = তুলনা
compatibility = সঙ্গতিপূর্ণতা
compatible = সঙ্গতিপূর্ণ
compel = জোর করা
compensation = ক্ষতিপূরণ
compete = প্রতিযোগিতা
competition = প্রতিযোগিতা
competitive = আকর্ষণীয়
competitiveness = প্রতিযোগিতা
competitor = প্রতিযোগী
compilation = সঙ্কলন
compile = সঙ্কলন করা
compiled = কম্পাইলকৃত
complain = অভিযোগ
complaint = নালিশ
complete = শেষ করা
completed = সম্পন্ন
completely = সম্পূর্ণভাবে
completion = পরিপূরণ
complex = জটিল
complexity = জটিলতা
compliance = সম্মত
compliant = সম্মত
complication = জটিলতা
component = উপাদান
components = উপাদান
compose = একত্র করে গঠন করা
composed = গ্রন্থিত
composer = রচয়িতা
composite = যৌগিক
composition = গ্রন্থন
compound = যৌগ
compress = সঙ্কুচিত করা
compressed = সঙ্কুচিত
compression = কম্প্রেশন
comprise = গঠিত হওয়া
computation = গণনা
compute = গণনা করা
computers = কম্পিউটার
comrade = সঙ্গী
conceal = গায়েব করা
concealed = গুপ্ত
concede = মেনে নেওয়া
conceive = গর্ভবতী হওয়া
concentrate = মনোযোগ দেওয়া
concentration = মনঃসংযোগ
concern = উদ্বিগ্ন হওয়া
concerning = সম্পর্কে
concert = মিলন
concise = সংক্ষিপ্ত
concluding = শেষকালীন
conclusion = সিদ্ধান্ত
conclusive = চূড়ান্ত
condemn = নিন্দা করা
condensation = ঘনীভবন
condition = অবস্থা
conditional = শর্তাধীন
conditions = অবস্থা
condom = কন্ডোম
condominium = অ্যাপার্টমেন্ট
conduct = পরিচালনা করা
conductor = বাহক
confederation = কনফেডারেশন
confer = খেতাব প্রদান করা
conference = অধিবেশন
confidence = আত্মবিশ্বাস
confident = আত্মবিশ্বাসী
confidential = গোপনীয়
configure = কনফিগার
configuration = কনফিগারেশন
confine = সীমাবদ্ধ করা
confined = বদ্ধ
confinement = গারদ
confirm = দৃঢ়তরভাবে প্রতিপন্ন করা
confirmation = নিশ্চিত প্রমাণ
confirmed = নিশ্চিত
conflict = সংঘাতে জড়িয়ে পড়া
confluence = সঙ্গম
confluent = নদী-সঙ্গম
conform = মেনে চলা
conformist = অনুগামী ব্যক্তি
conformity = সাদৃশ্য
confound = তালগোল পাকান
confused = বিভ্রান্ত
confusing = বিভ্রান্তকর
confusion = বিভ্রান্তি
congestion = জট
congratulate = অভিনন্দন জানান
congratulation = অভিনন্দন
congratulations = অভিনন্দন
congratulations = অভিনন্দন
congress = কংগ্রেস
conjecture = আন্দাজ
conjugal = দাম্পত্য
conjunction = যুক্তাক্ষর
connect = সংযোগ কর
connect = সংযোগ স্থাপন
connected = সংযুক্ত
connecting = সংযোগ স্থাপিত হচ্ছে
connection = সংযোগ
connections = সংযোগ
conquer = জয় করা
conscience = বিবেক
consciousness = সচেতনতা
consecutive = পরপর
consensus = ঐক্যমত
consent = অনুমোদন
consent = অনুমোদন  করা
consequence = ফল
consequent = অনুবর্তী
consequently = ফলে
conservative = সংরক্ষণশীল
conservatively = রক্ষণশীলভাবে
consider = বিবেচনা
consideration = বিবেচনা
consider = ছাড় দেওয়া
consist = গঠিত
consistency = ধারাবাহিকতা
consistently = ধারাবাহিকভাবে
consists = গঠিত
consolation = সান্তনা
console = কনশোল
consolidation = দৃঢ়করণ
consonant = ব্যঞ্জণবর্ণ
consortium = সংঘ
conspiracy = ষড়যন্ত্র
constancy = অপরিবর্তনীয়তা
constant = ধ্রুবক
constantly = অবিরামভাবে
constellation = তারামণ্ডলী
constituent = নির্বাচনকারী
constitute = গঠন করা
constitution = সংবিধান
constitutionality = সাংবিধানিকতা
constrain = বাধ্য করা
construct = নির্মান করা
construction = নির্মাণ
constructive = গঠনমূলক
consult = পরামর্শ করা
consultation = আলোচনা
consumer = ভোক্তা
consuming = খাওয়া
contact = যোগাযোগ
contact = যোগাযোগ করা
contacting = যোগাযোগ করা হচ্ছে
contagious = সংস্পর্শের মাধ্যমে সংক্রামক
contain = ধারণ করা
container = ধারক
containers = ধারক
containing = ধারণ করে
contains = ধারণ করা
contaminated = দূষিত
contemporary = সমকালীন
content = ভিতরের উপাদান
contents = অভ্যন্তরস্থ বস্তু
contestant = প্রতিযোগী
context = প্রসঙ্গ
contexts = প্রসঙ্গ
continence = সংযম
continent = মহাদেশ
continual = অবিরাম
continue = অগ্রসর হওয়া
continue = চালিয়ে যাওয়া
continues = চলছে
continuing = চলমান
continuous = ক্রমাগত
continuously = অবিরামভাবে
contraception = গর্ভনিরো‌ধ
contract = চুক্তি
contraction = সঙ্কোচন
contrast = বৈসাদৃশ্য
contribute = অংশপ্রদান
contributed = দানকৃত
contribution = অবদান
contributions = অবদানসমূহ
contributor = অংশ গ্রহণকারী
contributors = অংশ গ্রহণকারীগণ
control = নিয়ন্ত্রণ
control = নিয়ন্ত্রণ করা
controlled = নিয়ন্ত্রিত
controls = নিয়ন্ত্রণ করে
controversial = বিতর্কিত
controversy = বিতর্ক
convection = পরিচলন
convenience = সুবিধা
convenient = সুবিধাজনক
convention = কনভেনশন
conventions = প্রথা
conversation = কথোপকথন
conversations = কথোপকথন
conversely = বিপরীতভাবে
conversion = রূপান্তর
convert = রূপান্তর
convert = রূপান্তর করা
converter = রূপান্তরকারী
convey = পৌঁছে দেওয়া
conveyance = যানবাহন
convict = দণ্ডিত অপরাধী
convince = দৃঢ়প্রত্যয় উত্পাদন করা
cook = রাঁধুনি
cook = কুক
cook = রান্না করা
cookies = কুকি
cool = ঠান্ডা
cool = ঠান্ডা করা
coolness = শীতলতা
cooperate = সহযোগিতা করা
cooperation = সহযোগিতা
cooperative = সহযোগী
coordinate = স্থানাংক
coordinator = সমন্বয়সাধনকারী
cop = পুলিশ
copied = কপিকৃত
copies = কপি
copy = কপি করা
copying = কপি করা হচ্ছে
copyright = কপিরাইট
copyright = সত্ত্বাধিকার
cordial = আন্তরিক
core = মূল
cork = কর্ক
corn = ভুট্টা
cornea = কর্নিয়া
corner = কোণ
cornerstone = মূলভিত্তি
corollary = অনুসিদ্ধান্ত
corporate = যৌথ
corpse = মৃতদেহ
correct = সঠিক
correct = ত্রুটিমুক্ত
corrected = সংশোধিত
correction = সংশোধন
correctly = সঠিকভাবে
correlated = পরস্পর সম্পর্কযুক্ত
correspond = সঙ্গতিপূর্ণ হওয়া
correspondent = প্রতিনিধি
corresponding = সংশ্লিষ্ট
corridor = করিডর
corroborate = সমর্থিত হওয়া
corrupt = বিকৃত
corrupt = দুর্নীতিবাজ
corruption = দুর্নীতি
corset = কাঁচুলি
cosmological = মহাবিশ্বতত্ত্বমূলক
cosmology = সৃষ্টিতত্ত্ব
cosmopolitan = বিশ্বজনীন
cost = খরচ
cost = মূল্য দেওয়া
costliest = সবচেয়ে দামি
costly = দামী
costs = খরচ
costume = পোশাক
cosy = আরামদায়ক
cottage = কুটির
cotton = তুলা
cough = কাশি
council = পরিষদ
counsel = উপদেশ
count = গণনা
count = গুনতি
count = গণনা করা
counter = কাউন্টার
counterfeit = নকল
counterpart = প্রতিরুপ
counting = গণনা
countries = দেশগুলো
country = দেশ
countryman = দেশবাসী
county = কাউন্টি
coup = সামরিক অভ্যুথান
couple = দম্পতি
courage = সাহসীকতা
course = বিষয়
court = কোর্ট
courteous = নম্র
courts = আদালত
cover = ঢাকা দেওয়া
coverage = প্রতিবেদন প্রচার
covered = আবৃত
covers = কভার
cow = গরু
cowboy = রাখাল
coy = নম্র
coyness = নম্রভাব
crack = সুদক্ষ
cradle = দোলনা
crane = সারস
cranky = বদমেজাজী
crash = ভেঙ্গে পড়া
crashed = ভেঙে পড়েছে
crater = খাদ
crave = মিনতি করা
craving = আকুল কামনা
craziness = পাগলামি
create = তৈরি করা
created = সৃষ্ট
creating = তৈরি করছে
creation = সৃষ্টি
creative = সৃজনকর
creativity = সৃজনশীলতা
creator = সৃষ্টিকারী
credential = প্রশংসাপত্র
credibility = বিশ্বাসযোগ্যতা
credit = ধার দেওয়া
credits = স্বীকৃতি
crescent = হেলাল
crest = শিখর
crested = ঝোঁটন
crew = চালক
cricket = ক্রিকেট
criminal = অপরাধী
criminal = দূষ্কৃতী
cripple = পঙ্গু
crisis = সঙ্কট
criteria = বিচারধারা
criterion = বিচারধারা
critic = সমালোচক
critical = চরম সঙ্কটপূর্ণ
criticism = সমালোচনা
criticize = সমালোচনা করা
crocodile = কুমির
crony = অন্তরঙ্গ বন্ধু
crooked = অসাধু
crop = ফসল
crops = ফসল
cross = অতিক্রম করা, পার করা
crow = কাক
crowd = ভীড়, ভিড় করা
crown = মুকুট, শিরোপা দেওয়া
crude = অপরিপক্ক
cruel = নিষ্ঠুর
crumble = ভেঙে টুকরো টুকরো করা, পতন হওয়া
crush = নিষ্পেষণ
cry = কাঁদা
crypt = ক্রিপ্ট
crystal = স্ফটিক
cube = ঘনক্ষেত্র
cuckoo = কোকিল
cucumber = শশা
cuff = জামার আস্তিনের নিম্নাংশ
culmination = মধ্যগমন
cultivate = চাষ করা
cultivation = চাষ
cultural = সাংস্কৃতিক
culture = সংস্কৃতি
cultured = বিনয়ী
cultures = সংস্কৃতি
cumin = কাল জিরা
cumulative = ক্রমবর্ধমান
cup = পেয়ালা
curd = দধি
curl = বাঁক
curled = বক্র
currency = টাকা
current = বর্তমান
current = বর্তমানে ব্যবহৃত
currently = বর্তমানে
curriculum = পাঠক্রম
curse = অভিশাপ
curtain = পর্দা
curvature = বক্রতা
curve = বক্র
curves = বক্ররেখা
cusp = শৃঙ্গ
custom = স্বনির্বাচিত, প্রথা
customer = গ্রাহক
customers = খদ্দের
customization = স্বনির্বাচন
customized = স্বনির্বাচিত
cut = কেটে ফেলা
cycle = চক্র
dad = বাবা
daddy = বাবা
dailies = দৈনিক সংবাদপত্র
daily = প্রতিদিন
dally = অলস সময় কাটানো
dam = বাঁধ
damage = ক্ষতি
damage = ক্ষতি করা
damaged = ক্ষতিগ্রস্ত
damned = অভিশপ্ত
dampness = আর্দ্রতা
damsel = তরুণী
dance = নৃত্য
dance = নাচা
danger = বিপদ
dangerous = বিপজ্জনক
dark = অন্ধকার
dark = আঁধার
darker = আরো অন্ধকার
darkest = অন্ধকারতম
darkness = আঁধার
darkroom = অন্ধকার ঘর
darling = প্রিয়তম
das = দাস
data = ডেটা
data = তথ্য
database = ডেটাবেস
databases = ডেটাবেস
date = তারিখ
dates = তারিখ
dating = ডেটিং
daughter = কন্যা
davenport = কারুকার্যপূর্ণ লেখার টেবিল
dawn = ভোর
day = দিন
daylight = দিনের আলো
daylong = দিনব্যাপী
days = দিন
daytime = দিবাভাগ
daytime = দিনের বেলা
dd = ডিডি
deactivated = অচল
dead = মৃত
deadlock = অচলবস্থা
deadly = মারাত্নক
deaf = বধির
deal = চুক্তি
deal = চুক্তি করা
deal = দেবদারু কাঠ
dean = ডিন
dear = প্রিয়
dearth = অভাব, অনটন, আকাল
death = মৃত্যূ
deathless = মৃত্যুহীন
debate = বিতর্ক
debit = নগদ
debonair = প্রফুল্ল
debris = ধ্বংসাবশেষ
debt = ঋণ
debug = ত্রুটিমুক্ত করা
debug = ত্রুটিমুক্ত করা
debugging = ডিবাগিং করা
debugging = ত্রুটিমুক্ত করা
debut = অভিষেক
debut = অভিষেক হওয়া
decade = দশক
decadence = অধঃপতিত অবস্থা
decades = দশক
decaying = ক্ষয়শীল
decedent = মৃত ব্যক্তি
deceive = ঠকানো
deception = প্রবঞ্চনা
decide = নির্ধারণ করা
decimal = দশমিক
decimal = দশমিক
decision = সিদ্ধান্ত
decisive = চূড়ান্ত
declaration = ঘোষণা
declare = ঘোষণা করা
decline = অস্বীকার
decline = অস্বীকার করা
decline = পতন
declining = নামতে থাকা
decode = ডিকোডিং করা
decode = ডিকোডিং করা
decoded = ডিকোডকৃত
decoding = ডিকোডিং
decrease = হ্রাস
decrease = কমান
decry = নিন্দা করা
deduce = অনুমান করা
deduction = অনুমান
deem = গণ্য করা
deep = গভীর
deeply = গভীরভাবে
deer = হরিণ
default = ডিফল্ট
default = স্বাভাবিক অবস্থায় ব্যবহৃত
defaults = ডিফল্ট অবস্থায়
defeat = পরাজয়
defeat = পরাজিত করা
defect = খুঁত
defendant = প্রতিবাদী
defensive = প্রতিরোধমূলক
defer = বিলম্বিত করা
deferent = শীঘ্রবৃত্ত
deferred = বিলম্বিত
defiance = আদেশ পালন করতে অস্বীকার করা
deficit = ঘাটতি
define = উল্লেখকরণ
defined = উল্লেখকৃত
definite = নিশ্চিত
definitely = নিশ্চিতভাবে
definition = সংজ্ঞা
defoliation = পাতা ঝরান
deformed = বিকৃত
deft = দক্ষ
degeneracy = অধঃপতন
degrees = ডিগ্রি
delay = বিলম্ব
delay = বিলম্বিত করা
delayed = বিলম্বিত
delegate = প্রতিনিধি
delete = মুছে ফেলা
deleting = মোছা হচ্ছে
deliberate = সুচিন্তিত
delicate = সুস্বাদু
delicious = সুস্বাদু
delight = উত্ফুল্লতা
delight = আনন্দ দেওয়া
delight = আনন্দিত হওয়া
delightful = আনন্দময়
delinquency = অপচার
deliver = বিলি করা
delivery = বিলি করা
delta = ডেলটা
delve = খনন করা
demand = চাহিদা
demand = দাবী করা
democracy = গণতন্ত্র
democratic = গনতন্ত্রী
demolish = ধ্বংস করা
demon = দানব
demonstrate = প্রতিপাদন করা
demoralization = আত্মবিশ্বাসহীনতা
denied = প্রত্যাখ্যাত
denominator = হর
dense = ঘন
density = ঘনত্ব
deny = অস্বীকার করা
department = বিভাগ
departure = বহির্গমন
depend = নির্ভর কর
dependency = নির্ভরতা
dependent = নির্ভরশীল
dependent = অধীন
depending = নির্ভর
deplore = গভীর পরিতাপ করা
deport = নির্বাসিত করা
deposit = জমা হওয়া
depositary = ন্যাসরক্ষক
deposition = গচ্ছিত রাখা
depression = হতাশা
depth = গভীরতা
deputy = সহকারী
derision = পরিহাস
derivative = উদ্ভূত
derive = উৎপত্তি নির্ণয় করা
deriving = উৎপন্ন
des = ডি-ই-এস
descend = অবতরণ
describe = বর্ণনা করা
described = বর্ণনাকৃত
describing = বর্ণনা করা হচ্ছে
description = বর্ণনা
descriptions = বর্ণনা
descriptive = বর্ণনামূলক
desert = মরুভূমি
deserve = যোগ্য হওয়া
design = নকশা
design = পরিকল্পনা করা
designer = নকশাকারী
desire = আকাঙ্খা
desired = প্রত্যাশিত
desktop = ডেস্কটপ
desperately = প্রাণপণে
despise = অবজ্ঞা করা
destination = গন্তব্য
destiny = নিয়তি
destitute = চরম অভাবগ্রস্ত
destroy = ধ্বংস করা
destruction = ধ্বংস
detach = বিযুক্তকরণ
detached = আলাদা
detail = পুঙ্খানুপুঙ্খ বর্ণনা
detailed = পুঙ্খানুপুঙ্খ
detailed = বিস্তারিত বর্ণনা
details = বিশদ বর্ণনা
details = বিস্তারিত
detain = আটকে রাখা
detect = সনাক্তকরণ
detected = সনাক্তকৃত
detection = সনাক্তকরণ
detective = গোয়েন্দা
detergent = ডিটার্জেন্ট
deteriorate = অবনতি হওয়া
deterioration = নষ্ট হয়ে যাওয়া
determine = নির্ধারণ
determine = নির্ধারণ করা
determining = গুরুত্বপূর্ণ
determinning = দৃঢ় সিদ্ধান্ত নেয়া, সংকল্প করা
deterrent = প্রতিরোধক
detonate = বিস্ফোরিত করা
develop = বিকশিত করা
developed = উন্নত
developer = ডেভেলপার
developers = ডেভেলপারগণ
developing = উন্নয়নশীল
development = উন্নতিসাধন
deviation = বিচ্যুতি
device = ডিভাইস
devices = ডিভাইস
devoid = বিহীন
devoted = অনুরক্ত
devotional = ভক্তিমূলক
devout = ধর্মপ্রাণ
dew = শিশির
diabolical = নারকীয়
diagnose = রোগ নির্নয় করা
diagnosis = রোগনির্ণয়
diagnostic = রোগনির্ণয় সম্পর্কিত
diagnostics = রোগনির্ণয়তত্ত্ব
diagonal = তির্যক
dial = ডায়াল
dial = ডায়াল করা
dialing = ডায়াল করা হচ্ছে
dialogue = কথোপকথন
diamond = হীরক
diarrhea = উদরাময়
diary = ডাইরি
dictation = আদেশ
dictionary = অভিধান
dictum = নীতি-বাক্য
die = মর
die = মরা
diesel = ডিজেল
diesel = ডিজেল
differ = ভিন্নমত হওয়া
difference = পার্থক্য
different = আলাদা
differently = আলাদাভাবে
difficult = কঠিন
difficulty = ঝামেলা
diffuse = পরিব্যাপ্ত
diffusion = বিকীর্ণ করা
dig = খনন করা
digest = সারসঙ্কলন সম্বলিত বই
digest = হজম করা
digit = অংক
digital = ডিজিট্যাল
dignity = মর্যাদা
diktat = নির্দেশনা
dilate = প্রসারিত করা
dilute = লঘু করা
dilution = লঘুকরণ
dimension = মাত্রা
dimensions = মাত্রা
dinner = সান্ধ্যভোজ
dip = নতি
diplomat = কূটনীতিক দূত
diplomatic = কূটনৈতিক
dire = ভয়াবহ, ভীষণ
direct = সরাসরি
direct = সরাসরি
direction = দিকনির্দেশনা
directionless = দিশাহীন
directionlessness = দিশাহীনতা
directly = সরাসরিভাবে
director = পরিচালক
directorate = পরিচালকবর্গ
directories = ডিরেক্টরী
directory = ডিরেক্টরি
directory = ডিরেক্টরী
disability = শারীরিক প্রতিবন্ধী
disable = অকার্যকর করা
disabled = নিষ্ক্রিয়
disabling = নিষ্ক্রিয়করণ
disadvantageous = অসুবিধাজনক
disagreement = অনৈক্য
disallow = অনুমতি না দেওয়া
disappear = অন্তর্ধান করা
disappointed = হতাশ
disappointingly = হতাশাগ্রস্ত হয়ে
disappointment = হতাশা
disarmament = নিরস্ত্রীকরণ
disaster = বিপর্যয়
disbelief = অবিশ্বাস
disc = ডিস্ক
discard = বাতিল
discarded = বাতিলকৃত
discerning = তীক্ষ্ণ-বুদ্ধি সম্পন্ন
disciplinary = নিয়মরক্ষা
discipline = শৃঙ্খলা
disclosed = উন্মুক্ত
disconnect = সংযোগ বিচ্ছিন্ন করা
disconnected = সংযোগ বিচ্ছিন্নকৃত
disconnecting = সংযোগ বিচ্ছিন্ন করা হচ্ছে
discount = ছাড়
discover = খুঁজে বার করা
discovery = আবিষ্কার
discreet = বিচক্ষণ
discreetly = বিচক্ষণভাবে
discriminate = বৈষম্যমূলক আচরণ করা
discrimination = বৈষম্য
discriminatory = পক্ষপাতমূলক
discuss = আলোচনা করা
discussion = আলোচনা
disdain = ঘৃণা করা
disease = জ্বরা
disembodied = বিদেহী
disk = ডিস্ক
diskette = ডিস্কেট
disks = ডিস্ক
dislike = অপছন্দ করা
dislocated = স্থানান্তরিত
dismante = ভেঙে ফেলা
disobedience = অসহযোগ
disobey = নির্দেশ না মানা
disorderly = বিশৃঙ্খল
displace = স্থানচ্যুত কর
display = ডিসপ্লে
display = পর্দা
display = প্রদর্শন করা
displaying = প্রদর্শনরত
displays = প্রদর্শন করে
dispute = বিতর্ক
dispute = বিতর্ক
disputed = বিতর্কিত
disquiet = অশান্ত
disrupt = সংহতিনাশ করা
disruption = সংহতিনাশ
disruptive = সংহতিনাশক
dissent = মত পার্থক্য
distance = দূরত্ব
distaste = অপছন্দ করা
distinct = আলাদা
distinction = স্বাতন্ত্র্য
distinguish = আলাদা করা
distort = বিকৃত করা
distortion = বিকৃতি
distribute = বন্টন করা
distributed = বণ্টিত
distributing = বন্টন
distribution = বন্টন
distributions = বন্টন
distributor = পরিবেশক
district = জেলা
districts = জেলা
disturb = বিরক্ত করা
dither = দ্বিধাগ্রস্ত
dive = ঝাঁপ দেওয়া
divergent = পৃথক
diverse = বিবিধ
diversified = বিবিধ
diversity = বৈচিত্র
divert = সরিয়ে নেওয়া
divide = বিভাজন
divide = ভাগ করা
dividend = ভাজ্য
division = বিভাগ
divorce = বিবাহবিচ্ছেদ
divorce = বিবাহ বিচ্ছেদ
do = কর
do = করা
do = করা
dock = ডক
dock = ডক করা
document = ডকুমেন্ট
document = নথি
document = নথী
documentation = ডকুমেনটেশন
documents = ডকুমেন্ট
dolce = মিষ্ট
doll = পুতুল
dollar = ডলার
domain = ডোমেন
dome = গম্বুজ
domestic = ঘরোয়া
dominate = পদদলিত করা
domination = কর্তৃত্ব
dominion = শাসন
donate = দান করা
done = সম্পন্ন
donkey = গাধা
donor = দাতা
donut = বৃত্তাকার একটি খাদ্য, ডোনাট
door = দরজা
doors = দরজা
dot = বিন্দু
dots = ফুটকি
double = দ্বিগুণ
doubt = দ্বন্দ্ব
doubt = সন্দিহান হওয়া
doubtful = সন্দেহজনক
down = নিচ
down = নিচে
downgrade = ডাউনগ্রেড
download = ডাউনলোড
download = ডাউনলোড করা
downloads = ডাউনলোড
downloaded = ডাউনলোডকৃত
downloading = ডাউনলোড
downtown = শহরতলী
dozen = ডজন
dozens = ডজন
draconian = নির্মম
draft = খসড়া
drag = টেনে নিয়ে যাওয়া
drag = টেনে নিয়ে যাওয়া
dragnet = টানাজাল
drain = বার করা
dramatic = নাটকীয়
dramatically = নাটকীয় ভাবে
draped = সজ্জিত
draught = ঔষধের মাত্রা
draw = আঁকা
draw = আঁকা
drawer = ড্রয়ার
drawing = ড্রয়িং
drawn = অঙ্কিত
dream = স্বপ্ন
dream = স্বপ্ন দেখা
dress = ড্রেস
drifting = ভেসে যাওয়া
drill = অনুশীলন
drink = পানীয়
drink = পান করা
drink = পান করা
drinking = পানীয়
drinking = পানীয়
drive = চালায়
drive = চালান
drive = চালনা করা
driven = চালিত
driver = চালক
drivers = ড্রাইভার
drives = চালায়
driving = চালনা
drone = পুরুষ মৌমাছি
drop = ফেলা
drop = ফোঁটা
drop = ফেলে দেওয়া
drought = অনাবৃষ্টি
drug = ড্রাগ
drugstore = ওষুধের দোকান
drum = ঢোল
drunk = মাতাল
dry = শুকনা
dual = দ্বৈত্ব
duct = নালী
dudgeon = ক্রোধ
due = বাকী
due = যথোচিত
due = পাওনা
dull = নিরানন্দময়
dumb = বোবা
dump = ফেলে দেওয়া
dump = ফেলে দেওয়া
dun = মেটে রঙ
dung = মল
duplicate = নকল
duplicate = নকল করা
durable = টেকসই
duration = সময়কাল
during = সময়ে
dutiful = কর্তব্যনিষ্ঠ
duty = কর্তব্য
dwarf = বামন
dwell = বাস করা
dweller = বাসিন্দা
dye = রং করা
dynamic = গতিশীল
dynamic = গতিময়
dynamically = চলন্ত অবস্থায়
dynamics = গতিবিদ্যা
dynastic = রাজবংশীয়
dynasties = রাজবংশ
dynasty = রাজবংশ
e.gG= উদাঃ
each = প্রত্যেক
ear = কান
earlier = গোড়ার দিকে
earliest = যথাশীঘ্র
early = আগের
early = আগে
earn = আয় করা
earring = কানের দুল
earthbound = পৃথিবী অভিমুখী
earthly = সাংসারিক
earthquake = ভূকম্পন
easier = সহজতর
easily = সহজভাবে
east = পূর্ব
east = পূর্ব
eastern = পূর্ব
easy = সহজ
easy = সহজ
eat = খাওয়া
eatable = খাদ্য
eccentricity = উত্‍কেন্দ্রতা
eclectic = সঙ্কীর্ণতামুক্ত
eclipse = গ্রহণ
ecliptic = ক্রান্তিবৃত্ত
economic = অর্থনৈতিক
economics = অর্থনীতি
economy = অর্থব্যবস্থা
edge = কিনারা
edible = খাদ্য
edifice = অট্টালিকা
edit = এডিট
edited = সম্পাদিত
editing = সম্পাদন
edition = সংস্করণ
editor = সম্পাদক
editorial = সম্পাদকীয়
editors = সম্পাদক
educate = শিক্ষিত করা
educated = শিক্ষিত
education = শিক্ষা
educational = শিক্ষা সংক্রান্ত
educator = শিক্ষাবীদ
effect = প্রভাব
effective = কার্যকরী
effectively = কার্যকরভাবে
effectiveness = কার্যকারিতা
effects = প্রভাব
efficient = কুশলী
effort = কঠোর প্রচেষ্টা
effortless = অনায়াস
efforts = প্রচেষ্টা
egg = ডিম
eight = আট
eighteen = আঠেরো
eighteenth = অষ্টদশ
eighth = অষ্টম
either = হয়
eject = বের করে দেওয়া
eject = বের করে দেওয়া
ejecting = বের করছে
elapsed = অতিবাহিত
elasticity = নমনীয়তা
elated = উল্লসিত
elbow = কনুই
elder = বয়োজ্যেষ্ঠ
elect = নির্বাচিত করা
elected = নির্বাচিত
election = নির্বাচন
electric = বৈদ্যুতিক
electrically = বৈদ্যুতিকভাবে
electricity = তড়িৎ
electromagnet = তড়িৎ-চুম্বক
electromagnetism = তড়িৎ-চুম্বকীয় তত্ত্ব
electronic = ইলেকট্রনিক
electronics = ইলেকট্রনিক্স
electrons = ইলেকট্রন
elegant = রুচিশীল
element = উপাদান
elementary = প্রাথমিক
elephant = হাতি
elevation = উচ্চতা
elevator = লিফ্‌ট
eleven = এগার
eleventh = ১১তম
eligibility = যোগ্যতা
eligible = উপযুক্ত
eliminate = ধ্বংস করা
elimination = ধ্বংস
elite = অভিজাত
elongation = প্রতান
else = অন্যথায়
elsewhere = অন্য জায়গায়
elsewhere = অন্য কোথাও
emancipate = মুক্ত করা
embarrassment = নাকানিচোবানি
embassy = দূতাবাস
embedded = সন্নিবেশিত
emblem = প্রতীক
embryo = ভ্রূণ
emerge = উদ্ভূত হওয়া
emergency = জরুরী
emergency = জরুরী অবস্থা
emit = বের করা
emotion = আবেগ
emotional = আবেগতাড়িত
emperor = সম্রাট
emphasize = জোর দিয়ে বলা
empire = সাম্রাজ্য
empires = সাম্রাজ্য
empirical = প্রায়োগিক
empirically = অভিজ্ঞতাবলে
employ = চাকরী দেওয়া
employee = কর্মচারী
employees = কর্মচারী
employer = নিয়োগকর্তা
employment = কাজ
empowerment = ক্ষমতায়ন
empty = ফাঁকা
empty = ফাঁকা করা
emulate = অনুকরণ করা
emulated = অনুকরণকৃত
emulator = এমুলেটর
enable = সক্রিয়
enable = সক্রিয় করা
enabled = সক্রিয়
enables = সক্রিয় করে
enabling = সক্রিয়করণ
encircled = আবৃত
encode = এনকোডিং করা
encoded = এনকোডকৃত
encoding = এনকোডিং
encoder = এনকোডার
encompass = পরিবেষ্টন
encounter = সম্মুখীন হওয়া
encounter = সম্মুখীন হওয়া
encountered = সম্মুখীন হওয়া
encourage = উৎ‍সাহিত করা
encouraged = উৎ‍সাহিত
encouragement = উৎসাহ
encroach = জবরদখল করা
encyclopedia = বিশ্বকোষ
end = শেষ
end = প্রান্ত
end = শেষ হওয়া
endangered = বিপন্ন
ending = শেষাংশ
endings = শেষাংশ
endotoxin = এন্ডোটক্সিন
endowment = স্থায়ী বৃত্তি
enemy = শত্রু
energetic = কর্মশক্তিসম্পন্ন
energetically = সক্রিয়ভাবে
energy = শক্তি
enforce = বলবৎ করা
enforced = কার্যকরী
engage = নিযুক্ত করা
engender = জন্ম দেওয়া
engine = ইঞ্জিন
engineer = ইঞ্জিনিয়ার
engineer = প্রকৌশলী
engineering = পূর্তবিদ্যা
engineering = ইঞ্জিনিয়ারিং
engineers = প্রকৌশলী
engrave = খোদাই করা
engraved = খোদাইকৃত
engulf = গ্রাস করা
enhance = উন্নত করা
enhance = বৃদ্ধি করা
enhanced = বর্ধিত
enhancement = বর্ধিতকরণ
enhancements = উন্নতি
enigma = ধাঁধা
enjoy = উপভোগ করা
enlarge = বিশদ করা
enlargement = পরিবর্ধন
enlighten = আলোকিত করা
enlist = তালিকাভুক্ত করা
enmity = শত্রুতা
enormous = প্রকান্ড
enough = যথেষ্ট
enough = পর্যাপ্ত
enough = যথেষ্ট
ensue = উদ্ভূত হওয়া
ensure = নিশ্চিতকরণ
enter = ঢুকুন
entered = ঢোকানো
entering = প্রবেশ করা
enterprise = উদ্যোগ
enters = প্রবেশ করা
entertain = চিত্তবিনোদন করা
entertainment = বিনোদন
enthusiasm = উদ্যম
enthusiastic = কর্মঠ
entice = প্ররোচিত করা
entice = আকৃষ্ট করা
entire = সমগ্র
entirely = সমগ্রভাবে
entities = সত্ত্বা
entity = সত্ত্বা
entrance = প্রবেশ
entrepreneur = বিনিয়োগকারী
entrepreneurs = বিনিয়োগকারী
entries = এন্ট্রি
entry = অন্তর্ভুক্তি
envelope = খাম
envelopes = খাম
environment = পরিবেশ
environments = পরিবেশ
envisage = বিবেচনা করা
epic = মহাকাব্য
epics = মহাকাব্য
epicycle = মন্দবৃত্ত
episode = পর্ব
episodes = পর্ব
epitome = সার-সংক্ষেপ
epoch = যুগ
equal = সমান
equal = সমকক্ষ করা
equalize = সমকক্ষ করা
equalizer = ইকুয়ালাইজার
equally = সমানভাবে
equation = সমীকরণ
equations = সমীকরণ
equator = নিরক্ষরেখা
equatorial = নিরক্ষীয়
equity = সাম্যতা
equivalent = সমতুল্য
era = যুগ
eradicate = সমূলে উৎপাটিত করা
erase = মুছে ফেলা
erasing = মুছে ফেলা
erroneous = ত্রুটিপূর্ণ
error = ত্রুটি
errors = ত্রুটি
erstwhile = তৎকালীন
es = এস
escalate = ধাপে ধাপে বৃদ্ধি পাওয়া
esophagus = খাদ্যনালি
especially = বিশেষভাবে
essential = আবশ্যিক
establish = স্থাপন
established = প্রতিষ্ঠিত
establishing = স্থাপন করছে
establishment = প্রতিষ্ঠান
estimate = সম্ভাব্য ব্যয়ের হিসাব
estimate = হিসাব করা
estimated = আনুমানিক
etc = ইত্যাদি
etc. = ইত্যাদি
eternal = অনন্ত
ethnic = নৃতাত্বিক
euphemism = সুভাষণ
evaluate = মূল্যায়ন করা
evaluation = মূল্যায়ন
evaporation = বাষ্পীভবন
eve = আগের রাত
even = জোড়
even = এমনকি
even = সমতল
evening = সন্ধ্যা
event = ঘটনা
eventual = অবশ্যম্ভাবী
evenutally = পরিশেষে
ever = সর্বদা
ever = চিরকাল
every = প্রতি
everybody = সকলে
everyday = প্রাত্যহিক
everyone = সবাই
everything = সবকিছু
evict = আইন বলে উচ্ছেদ করা
evidence = প্রমাণ
evil = শয়তান
evolution = বিবর্তন
evolve = বিবর্ধিত হওয়া
exact = সঠিক
exact = যথার্থ
exactly = যথাযথভাবে
exalt = মহিমান্বিত করা
exam = পরীক্ষা
examination = পরীক্ষা
examine = পরীক্ষা করা
example = উদাহরণ
examples = উদাহরণ
excavation = খনন
exceed = অতিক্রম
excel = ছাড়িয়ে যাওয়া
excellence = মহত্ত্ব
excellence = মহানুভবতা
excellent = সর্বোৎকৃষ্ট
except = ব্যতীত
except = ছাড়া
exception = ব্যতিক্রম
exceptional = ব্যতিক্রমী
excerpt = উদ্ধতি
excessive = অতিরিক্ত
exchange = আদান প্রদান
exchange = বিনিময়
excited = উত্তেজিত
exclude = বাদ দেওয়া
exclusive = স্বতন্ত্র
exclusively = একচেটিয়াভাবে
execute = রান করা
executed = নিষ্পন্ন
execution = কার্যকর করা
executive = কার্যকরী
exempt = দায়মুক্ত
exercise = অনুশীলন
exercise = অনুশীলন করা
exercising = চর্চা
exhaustive = সম্পূর্ণ
exhibit = প্রদর্শন করা
exhibition = প্রদর্শনী
exile = নির্বাসন
exist = অস্তিত্ব থাকা
exist = বিদ্যমান
existed = ছিল
existence = অস্তিত্ব
existing = বিদ্যমান
exists = অস্তিত্ব রয়েছে
exit = প্রস্থান
exit = প্রস্থান করা
exiting = প্রস্থান করা হচ্ছে
exorcism = ঝাঁড়ফুক
expand = ছাড়ানো
expanded = সম্প্রসারিত
expands = সম্প্রসারিত হয়
expansion = বিস্তার
expansive = বিস্তৃত
expect = আশা করা
expect = আশা করা
expectable = প্রত্যাশিত
expected = প্রত্যাশিত
expectedly = প্রত্যাশিতভাবে
expecting = প্রত্যাশা করা হচ্ছে
expedite = ত্বরান্বিত করা
expel = বহিষ্কার করা
expenditure = খরচ
expense = খরচ
expenses = খরচা
expensive = মূল্যবান
expensive = দামী
experience = অভিজ্ঞতা
experience = অনুভব করা
experience = অভিজ্ঞতা হওয়া
experienced = অভিজ্ঞ
experiment = পরীক্ষা
experimental = পরীক্ষামূলক
expert = বিশেষজ্ঞ
expert = বিশেষজ্ঞ
experts = বিশেষজ্ঞরা
expiration = তামাদি
expire = তামাদি হওয়া
explain = ব্যাখ্যা করা
explain = বর্ণনা করা
explanation = ব্যাখ্যা
explicitly = স্পষ্টভাবে
explode = বিস্ফোরণ ঘটান
exploit = শোষণ করা
exploit = শোষণ করা
exploitation = শোষণ
explosion = বিস্ফোরণ
explosive = বিস্ফোরক
export = রপ্তানি
export = রপ্তানি করা
exported = রপ্তানীকৃত
expose = খুলে দেওয়া
expose = প্রকট করা
express = ব্যক্ত করা
express = ব্যক্ত করা
expression = মান
expressions = অভিব্যক্তি
extempore = চটজলদি
extend = প্রসারিত করা
extended = বর্ধিত
extension = বর্ধিতাংশ
extensions = বর্ধিতাংশ
extensive = ব্যাপক
extent = সীমা
external = বাহ্যিক
externally = বাহ্যিকভাবে
extinguish = নির্বাপন করা
extra = অতিরিক্ত
extract = নিষ্কাশন করা
extract = নিষ্কাশন করা
extracted = নিষ্কাশিত
extracting = নিষ্কাশন
extraction = নিষ্কাশন
extractor = নিষ্কাশনকারী
extraordinary = অসাধারণ
extreme = প্রচন্ড
extreme = চূড়ান্ত
extremely = প্রচন্ডভাবে
extremist = চরমপন্থী
extremity = প্রান্তে
extrovert = বহির্মুখী
eye = নয়ন
eyeball = অক্ষি গোলক
eyes = চোখ
fabric = গঠন
fabulous = অলীক
face = মুখ
face = মুখমন্ডল
face = সম্মুখীন হওয়া
facilities = সুবিধা
facility = সুবিধা
fact = ঘটনা
factor = ফ্যাক্টর
factory = ফ্যাক্টরি
factory = কারখানা
faculty = বিভাগ
fade = বিবর্ণ
fail = ব্যর্থ হ
fail = ব্যর্থ হওয়া
failed = ব্যর্থ
failed = ব্যর্থ হওয়া
failure = ব্যর্থতা
faint = ক্ষীণ
fair = অনুকূল
fair = মেলা
fairly = ভালভাবে
fairy = পরী
fairy.tTle = পরীর গল্প
faith = বিশ্বাস
faithful = বিশ্বাসী
faithfully = যথাযথভাবে
fake = নকল
fall = পড়া
fall = পড়া
fallible = ভ্রমপ্রবণ
false = মিথ্যা
fame = সুনাম
famed = বিখ্যাত
familiar = পরিচিত
family = পরিবার
famous = বিখ্যাত
famously = বিখ্যাতভাবে
fan = পাখা
fancy = অভিনব
far = দূর
far = দুর
farewell = বিদায় সম্ভাষণ
farm = খামার
farm = গোলাবাড়ি
farmer = কৃষক
farmers = কৃষকগণ
fashion = ফ্যাশন
fast = দ্রুত
fast = দ্রুত
faster = দ্রুততর
fastness = দ্রুততা
fatal = মারাত্মক
fate = ভাগ্য
father = আব্বা
fault = দোষ
faultless = নিখুঁত
faults = দোষ
faulty = খারাপ
favor = প্রশ্রয়
favorite = প্রিয়
favorites = প্রিয়
favour = আনুকূল্য
favour = প্রশ্রয় দেওয়া
fawn = হরিণ-শিশু
fax = ফ্যাক্স
fear = ভয়
fear = ভয় করা
fear = ভয় করা
fearful = ভীতিজনক
feature = বৈশিষ্ট্য
featured = বিশিষ্ট
features = বৈশিষ্ট্য
federal = কেন্দ্রীয়
federally = কেন্দ্রীয়ভাবে
federation = ফেডারেশন
feed = জোগান দেওয়া
feedback = মন্তব্য
feeling = আবেগ
feet = ফুট
felicitous = সমৃদ্ধ
fellow = সহযোগী
female = মহিলা
feminine = স্ত্রীসুলভ
fence = বেড়া
fennel = মৌরী
fenugreek = মেথি
fermions = ফের্মিয়ন
fern = ফার্ণ
ferocious = হিংস্র
ferry = ফেরী
ferry = ফেরী করা
fertile = উর্বর
festival = উৎসব
festivals = উৎসব
festive = উল্লসিত
fetch = এনে দেওয়া
fetching = আনা হচ্ছে
fetid = দুর্গন্ধময়
fever = জ্বর
few = অল্প
fiber = তন্তু
fiberglass = রাসায়নিক পদ্ধতিতে কাঁচ দিয়ে তৈরি আঁশ
fickle = চঞ্চল
fiction = বানোয়াট
fictional = কাল্পনিক
field = ক্ষেত্র
field = ক্ষেত্র
fields = ক্ষেত্র
fifteen = পনের
fifteenth = পঞ্চদশ
fifth = পঞ্চম
fifty = পঞ্চাশ
fig = ডুমুর
fight = লড়াই
fight = লড়াই করা
fight = লড়াই করা
fighter = লড়াকু
figure = চিত্র
file = ফাইল
file = দাখিল করা
files = ফাইল
fill = ভরাট করা
fill = ভর্তি করা
filled = ভর্তি
film = ছায়াছবি
filter = ফিল্টার
filter = ফিল্টার করা
filters = ফিল্টার
final = চূড়ান্ত
finality = চূড়ান্ত
finally = পরিশেষে
finance = রাজস্ব
financial = আর্থিক
find = সন্ধান করা
find = খুঁজে পাওয়া
finding = প্রাপ্তি
fine = সুন্দর
fines = জরিমানা
finger = আঙুল
fingerprint = আঙুলের ছাপ
finish = শেষ
finish = শেষ করা
finished = শেষ
finisher = সম্পন্নকারী
finishing = নিখুঁত করা
fire = আগুন
fireball = অগ্নিগোলক
firefighting = অগ্নি-নির্বাপণ
firewood = জ্বালানী কাঠ
firmness = অপরিবর্তনীয়তা
first = প্রথম
fish = মাছ
fishing = মাছ ধরা
fission = বিদারণ
fit = উপযোগী
fit = খাপ খাওয়া
fitted = উপযুক্ত
five = পাঁচ
fix = মেরামত করা
fix = মেরামত করা
fixable = ঠিক করা যায় এমন
fixed = স্থায়ী
flag = ফ্ল্যাগ
flagship = প্রধান জাহাজ
flame = দাহ করা
flammable = দাহ্য
flare = দাউদাউ করে জ্বলা
flash = ফ্ল্যাশ
flat = চ্যাপ্টা
fleet = নৌবহর
flesh = মাংস
flexible = নমনীয়
flick = দপদপ করা
flight = উড়ান
flights = উড়ান
flimsy = তুচ্ছ
flip = উল্টানো
flip = ওলটান
flirtatious = বাচাল
float = ভাসা
floating = ভাসমান
flock = ভিড় করা
flood = বন্যা
flood = প্লাবিত হওয়া
floor = মেঝে
floppies = ফ্লপি
floppy = ফ্লপি
flounder = হাক পাক করা
flour = আটা
flourish = উন্নতিলাভ করা
flourish = উন্নতিলাভ করা
flow = বয়ে চল
flower = ফুল
flu = ফ্লু
fluctuations = ওঠা নামা
fluid = তরল
fluid = তরল
flush = ফ্লাশ করা
flute = বাঁশি
fly = মাছি
fly = ওড়া
foam = ফেনা
focus = নির্দিষ্ট করা
focus = ফোকাস করা
focus = কেন্দ্রবিন্দু
fodder = গোখাদ্য
fog = কুয়াশা
foggy = কুয়াশাচ্ছন্ন
fold = ভাজ
fold = ভাজ করা
folder = ফোল্ডার
folders = ফোল্ডার
folding = ভাঁজ করার সুবিধাযুক্ত
folio = পৃষ্ঠাসংখ্যা
folk = লোক
folklore = উপকথা
follow = অনুসরণ করা
followed = অনুসৃত
follower = অনুসারী
following = নিম্নলিখিত
following = পরবর্তী
foment = গজগজ করা
font = ফন্ট
fonts = ফন্ট
food = খাদ্য
foodstuff = খাদ্যবস্তু
fool = বোকা
foolish = নির্বোধ
foot = হাঁটা
footage = ফুটের মাপে দৈর্ঘ্য
football = ফুটবল
footballer = ফুটবলার
footwear = জুতো
for = জন্য
forage = পশুখাদ্য
foray = হানা দেওয়া
forbid = নিষেধ করা
forbid = নিষেধ করা
forbidden = নিষিদ্ধ
forborne = বিরত থাকা
force = বল
force = বাধ্য করা
forced = বহুশ্রমসাধ্য
forcefulness = শক্তিমানতা
forces = শক্তিসমূহ
forcibly = বলপ্রয়োগ করে
fore = অগ্রবর্তী
forecast = পূর্বাভাস
foreground = উপরের অংশ
foreign = বিদেশী
foreigner = বিদেশী
foremost = প্রধান
forest = বন
forestry = বনবিদ্যা
forever = চিরকালীন
forget = ভুলে যা
forgetful = বিস্মরণশীল
forgo = ত্যাগ করা
forgotten = ভুলে যাওয়া
fork = কাটা চামচ
forlorn = পরিত্যক্ত
form = আকার
form = সংগঠিত করা
formally = প্রথাগতভাবে
format = কাঠামো
format = ছাঁদ
formation = গঠন
formations = গঠন
formats = বিন্যাস
formatted = ফরম্যাটকৃত
formatting = ফরম্যাট করছে
formed = গঠিত
former = প্রাক্তন
formerly = ইতঃপূর্বে
forms = আকৃতি
forms = রূপ
formula = ফর্মূলা
fort = দুর্গ
forthwith = তৎক্ষণাৎ
fortune = দৈব্য
forty = চল্লিশ
forum = আলোচনাচক্র
forums = আলোচনাচক্র
forward = ফরওয়ার্ড
forward = সামনে
forwards = সামনে
fossil = জীবাশ্ম
foster = প্রতিপালিত
foul = জঘন্য
foundation = ফাউন্ডেশন
founded = স্থাপিত
founder = প্রতিষ্ঠাতা
foundry = ঢালাই কারখানা
fountain = ফোয়ারা
four = চার
fourteenth = ১৪তম
fourth = চতুর্থ
fox = শিয়াল
fps = এফ-পি-এস
fraction = ভগ্নাংশ
fractured = চুর্ণীভূত
fragrance = সৌরভ
frail = ভঙ্গুর
frame = ছাঁচ
frame = ফ্রেম
framework = কাঠামো
fraud = প্রতারণা
freak = রঙ্গ
freak = রঙ্গ করা
free = ছেড়ে দেয়া
free = মুক্ত
free = ফাঁকা থাকা
freedom = স্বাধীনতা
freely = মুক্তভাবে
freezing = অতি শীতল
french = ফরাসী
frenzy = প্রবল উত্তেজনা
frequencies = কম্পাঙ্ক
frequency = কম্পাংক
frequent = নিয়মিত
frequently = ঘনঘন
fresh = তাজা
fridge = ফ্রিজ
friendly = বন্ধুভাবাপন্ন
friendship = বন্ধুত্ব
fright = আতঙ্ক
frivolously = তুচ্ছভাবে
frog = ব্যাঙ
from = থেকে
front = সদর
frontend = ফ্রন্ট-এন্ড
frosting = হিমান্কের নীচে নেমে যাওয়া তাপমাত্রা
froth = ফেনা
fructose = ফলশর্করা
fruit = ফল
fruitful = ফলপ্রসূ
fruitless = নিষ্ফলা
ft = ফুট
fuck = যৌনসঙ্গম
fuel = ইন্ধন
fueloil = জ্বালানী তেল
full = পূর্ণ
full = সম্পূর্ণ
fullest = পূর্ণতম
fully = সম্পূর্ণভাবে
fun = মজা
function = কাজ
fundamental = মৌলিক
fundamentalism = মৌলবাদ
funeral = শেষকৃত্য
funniest = হাস্যকর
furious = ক্রোধোন্মত্ত
furnace = চুল্লি
furniture = আসবাবপত্র
further = আরও
fusion = জোড়া লাগানো
fussy = বিরক্তিকর
future = ভবিষ্যৎ‍‌
fuzzy = অস্পষ্ট
g = জি
gadget = ছোট যন্ত্র
gain = লাভ
gain = লাভ করা
gains = লাভ
galaxy = ছায়াপথ
gallery = গ্যালারি
galloping = দ্রুতবেগে ধাবমান
game = খেলা
games = খেলা
gang = দল
ganglion = স্নায়ু-গ্রন্থি
gangster = গুন্ডা
gap = ফাঁক
garbage = জজ্ঞাল
garland = মালা
garment = পোষাক
garments = পোষাক
gas = গ্যাস
gate = দরজা
gateway = গেটওয়ে
gather = সমবেত
gather = একত্রিত করা
gauge = গেজ
gay = সমকামী
gazelle = গাজলা হরিণ
gegenschein = প্রতিদীপ্তি
gem = রত্ন
gems = রত্ন
gender = লিঙ্গ
gender = লিঙ্গ
gene = জিন
general = সাধারণ
generally = সাধারণত
generating = তৈরি করা হচ্ছে
generation = উৎ‍পাদন
generator = উৎ‍পাদক
generic = সাধারণ
generous = উদার
generously = উদারভাবে
genie = জিন
genius = প্রতিভাবান
genocide = গণহত্যা
genre = গোত্র
gentleman = ভদ্রলোক
gentleness = ভদ্রতা
gently = আলতোভাবে
genus = বর্গ
geocentric = ভূকেন্দ্রিক
geographical = ভৌগলিক
geography = ভূগোল
geologic = ভূতাত্ত্বিক
geological = ভূতাত্ত্বিক
geology = ভূতত্ত্ব
geometric = জ্যামিতিক
geometry = জ্যামিতি
germ = জীবাণু
germinated = অঙ্কুরিত
get = পাওয়া
getting = আনছে
ghazal = উর্দু কবিতা
ghetto = শহরের দরিদ্র বস্তি এলাকা
ghost = ভূত
giant = দৈত্য
gibberish = হ-য-ব-র-ল
giddy = মাথা ঘোরা
gift = দান
gifted = প্রতিভাবান
gimmick = চটকদার বস্তু
ginger = আদা
girl = বালিকা
give = দেওয়া
give = দেওয়া
given = প্রদত্ত
glacier = হিমবাহ
glad = আনন্দিত
gladness = আনন্দ
glance = দৃষ্টি
glass = কাঁচ
glassware = কাঁচের বাসন
global = বিশ্বজনীন
globally = বিশ্বব্যাপী
globe = পৃথিবী
gloss = গ্লস
glow = প্রভা
glucose = গ্লুকোজ
glycol = গ্লাইকল
gnome = গনোম
go = চলা
go = যাওয়া
goal = লক্ষ্য
goat = ছাগল
god = আল্লাহ্
goddess = দেবী
godlike = দেবোপম
godliness = ধার্মিকতা
gold = সোনা
golden = সুবর্ণ
goldsmith = স্বর্ণকার
golf = গল্ফ
gone = অতীত
good = ভাল
gore = জমাট বাধা রক্ত
gorilla = গরিলা
gospel = দৈববাণী
gossip = গালগল্প
govern = শাসন করা
governess = গৃহশিক্ষিকা
governing = শাসক
government = সরকার
governmental = সরকারি
governor = রাজ্যপাল
grab = ধরা
grace = দয়া
grade = স্তর
gradient = নতি
gradients = ঢালের মাত্রা
grading = স্তর অনুসারে সাজানো
gradual = ক্রমশঃ অগ্রশীল
gradually = ধীরে ধীরে
graduate = স্নাতক
graduate = পাস করা
grain = দানা
grammar = ব্যাকরণ
grammatical = ব্যাকরণগত
grand = বৃহৎ
grandchild = নাতি
grandfather = ঠাকুরদা
grant = প্রদান
grant = প্রদান করা
granular = দানাদার
grape = আঙুর
grapefruit = আঙুর
graph = গ্রাফ
graphic = গ্রাফিক
graphical = গ্রাফিকাল
graphics = চিত্রছবি
grasp = উপলব্ধি
grasp = উপলব্ধি করা
grass = ঘাস
gratify = খুশি করা
gratis = বিনামূল্যে
gratitude = কৃতজ্ঞতা
grave = কবর
gravid = গাভিন
gravitation = মহাকর্ষ
gravitational = মহাকর্ষীয়
gravity = মহাকর্ষ
gray = ধূসর
gray = ধূসর
graybeard = বৃদ্ধলোক
great = মহান
greatly = অত্যন্ত
greed = লোভ
greedy = লোভী
green = সবুজ
greenest = সবুজতম
greet = অভিবাদন
greeting = অভ্যর্থনা
grin = মুচকি হাসি
grin = মুচকি হাসা
grinding = চূর্ণ করা
grotesquely = বীভৎস্য ভাবে
ground = মাঠ
groundless = ভিত্তিহীন
groundwork = ভিত্তি
group = শ্রেণী
group = গ্রুপ
group = দল
grouping = শ্রেণীবিভাগ
groups = দল
grow = বৃদ্ধি
growing = বাড়ন্ত
growth = বৃদ্ধি
guarantee = নিশ্চয়তা
guarantee = নিশ্চয়তা প্রদান করা
guard = রক্ষা করা
guard = রক্ষা করা
guardian = অভিভাবক
guess = আন্দাজ
guess = অনুমান করা
guess = অনুমান করা
guest = অতিথী
guests = অতিথি
guide = সহায়িকা
guide = পরিচালনা করা
guideline = নির্দেশাবলী
guilty = দোষী
guinea = গিনি
gullet = খাদ্যনালি
gum = মাড়ি
gun = বন্দুক
gunman = বন্দুকধারী
gunmen = বন্দুকধারী
guy = লোক
gypsum = ক্যালসিয়াম সালফেটের একটি খনিজ পদার্থ
hallo = অভিবাদন
higher = উচ্চতর
highest = উচ্চতম
hilsa = ইলিশ
himalayas = হিমালয়
hindi = হিন্দি
hindu = হিন্দু
hinduism = হিন্দু ধর্ম
home = বাড়ি
huge = প্রচুর
hydrogen = হাইড্রোজেন
handler = প্রক্রিয়াকারক
he/she = সে
here = এখান
highscore = উচ্চস্কোর
hail = অভিনন্দন জানান
handle = পরিচালনা করা
happen = ঘটা
have = থাকা
help = সাহায্য করা
herald = আগমনবার্তা ঘোষণা করা
hide = গোপন করা
honour = সম্মান করা
habit = অভ্যাস
habits = অভ্যাস
hail = অভিনন্দন জানান
hail = অভিনন্দন জানানো
hair = চুল
hairpiece = টুপি
half = অর্ধেক
halo = জ্যোতিশ্চক্র
ham = শুকরের মাংস
hammer = হাতুড়ি চালান
hammer = হাতুড়ি
hamper = বড় ঝুড়ি
hand = হাত
hand = হাত
hand = হাত
handbook = গাইডবই
handbooks = গাইডবই
handed = হস্তান্তরকৃত
handicrafts = হস্তশিল্প
handle = হাতল
handle = হ্যান্ডল
handlers = পরিচালক
handling = পরিচালন
handshake = হাত মেলানো
handsome = সুদর্শন
handy = কাজের
hang = ঝোলান
hang = ঝোলান
hanging = ঝুলন্ত
hanging = ঝুলন্ত
happen = ঘটা
happen = সংঘটিত হওয়া
happening = ঘটনা
happiness = সুখ
happy = সুখী
hard = শক্ত
harddisk = হার্ড ডিস্ক
hardship = প্রতিকূলতা
harm = ক্ষতি
harm = ক্ষতি করা
harmful = ক্ষতিকর
harmless = নিরীহ
harmonic = ঐকতান
harmony = সম্প্রীতি
harvest = ফসল ফলানো
has = আছে
has = আছে
hash = হ্যাশ
hash = হ্যাশ করা
hashing = হ্যাশিং
hastily = দ্রুতভাবে
hat = টুপি
hate = ঘৃণা কর
hate = ঘৃণা করা
hate = ঘৃনা করা
haul = বহন করা
hauling = বহন
have = আছে
having = থাকা
hawker = ফেরিওয়ালা
hawking = হকিং
he = সে
head = মাথা
head = প্রধান
head = নেতৃত্ব দেওয়া
headache = মাথা ব্যাথা
header = শিরোনাম
heading = শিরোনাম
headings = শিরোনাম
headline = শিরোনাম
headlines = শিরোনাম
headquarters = সদর
healer = আরোগ্যকারী
health = স্বাস্থ্য
healthcare = স্বাস্থ্যপরিশেবা
healthy = স্বাস্থ্যসম্মত
hear = শোনা
hearsay = গুজব
heart = হৃদয়
heartstopping = হৃদয়বিদারী
heat = তাপ দেওয়া
heated = গরমকৃত
heaven = স্বর্গ
heavier = অধিকতর ওজনদার
heaviest = সর্বোচ্চ ওজনদার
heavy = ভারী
heavyweight = হভিওয়েট
height = উচ্চতা
heinous = ঘৃণ্য
held = ধরা
helicopter = হেলিকপ্টার
helix = হেলিক্স
hell = দোযখ
hell = নরক
hellfire = দোযখের আগুন
hello = শুনুন
hello = ওহে
help = সহায়ক তথ্য
helper = সহায়তাকারী
helpful = সহায়ক
hence = তাই
hepatitis = হেপাটাইটিস
hepatitis = হেপাটাইটিস
her = তার
herald = আগমনবার্তা ঘোষণা করা
herbal = ভেষজ
herd = পশুর দল
here = এখানে
heritage = ঐতিহ্য
hero = নায়ক
heroic = বীরোচিত
heroically = বীরত্বপূর্ণভাবে
heroine = নায়িকা
heroism = বীরত্ব
hesitate = ইতস্ততঃ করা
hey = ওহে
hibernate = জড়ভাবে শীত কাটানো
hiccup = হিচকি
hidden = লুকানো
hidden = লুক্কায়িত
hide = আড়াল করা
hide = গোপন করা
hide = লুকোন
hierarchy = ক্রমোচ্চ শ্রেণীবিভাগ
high = উচ্চ
high = উঁচু
high.qQality = উচ্চ গুনমানসম্পন্ন
higher = আরো উঁচু
highest = সর্বোচ্চ
highlighted = চিহ্নিত
highly = উচ্চভাবে
highway = মহাসড়ক
highways = মহাসড়ক
hike = পায়ে হাটা
hill = ছোট পাহাড়
hilly = পার্বত্য
him = তার
hindrance = অন্তরায়
hint = আভাস
hint = ইঙ্গিত
hired = ভাড়াটে
historian = ইতিহাসবিদ
historic = ঐতিহাসিক
historical = ঐতিহাসিক
historically = ঐতিহাসিকভাবে
history = ইতিহাস
hit = আঘাত
hobby = শখ
hockey = হকি
hold = ধরা
hold = ধরা
holder = ধারক
holders = ধারক
hold = ধরা
hole = গর্ত
holes = গহ্বর
holiday = ছুটির দিন
holidays = ছুটির দিন
holocaust = খান্ডবদহণ
holster = খাপ
holy = পবিত্র
home = বাড়ি
home = বাড়ি
home = গৃহাগমন করা
home = স্বদেশ যাওয়া
homebuilder = বাড়ি নির্মাতা
homeland = মাতৃভূমি
homeless = গৃহহীন
homemade = ঘরের তৈরি
homeownership = বাড়ির মালিকানা
homicidal = নরঘাতী
homosexual = সমকামী
homosexual = সমকামী
honest = সৎ
honey = মধু
honeymoon = মধুচন্দ্রিমা
honor = সম্মান
honorable = সম্মানিত
honorary = অবৈতনিক
honored = সম্মানিত
honour = সম্মান
hoodlum = গুন্ডা
hope = আশা
hope = আশা করা
hopeful = আশাবাদী
hopes = আশা
horizon = দিগন্ত
horizontal = আনুভূমিক
horizontal = আনুভূমিক
horizontally = অনুভূমিকভাবে
hornet = ভিমরুল
horrible = জঘন্য
horribly = ভয়ঙ্করভাবে
horse = ঘোড়া
horseman = অশ্বারোহী
hospitality = আতিথেয়তা
host = হোস্ট
host = আমন্ত্রক
hostage = পণবন্দী
hostess = অতিথিসেবক
hostile = প্রতিকূল
hostile = শত্রুভাবাপন্ন
hosting = হোস্টিং
hosts = আয়োজন করে
hot = গরম
hour = ঘন্টা
hours = ঘন্টা
house = আশ্রয় দেওয়া
houseboat = ভাসমান বাড়ি
household = ঘরোয়া
housekeeping = গৃহপরিচর্যা
housewife = গৃহবধূ
how = কেমন
however = তাহলেও
howl = গর্জন করা
hub = কেন্দ্র
huddle = গাদাগাদী করে থাকা
hue = রঙের সূক্ষ তারতম্য
huge = বিশাল
hugely = বিশালভাবে
hullabaloo = চেঁচামেচি
human = মানবিক
human = মানুষ
human.rRghts = মানবাধিকার
humane = মানবিক
humanitarian = মানবিক
humanity = মনুষ্যত্ব
humanly = মানবিকভাবে
humblest = নম্রতম
humid = আর্দ্র
humidity = আর্দ্রতা
humorist = রসিক
hundred = শত
hundreds = শতশত
hunger = ক্ষুধা
hungry = ক্ষুধার্ত
hunt = শিকার করা
hunt = শিকার করা
hunting = শিকার করা
hurl = সজোরে নিক্ষেপ করা
hurry = দ্রুত অগ্রসর হওয়া
hurt = বেদনা দেওয়া
hurt = আহত করা
hurt = আঘাত করা
husband = স্বামী
hutch = হাচ
hybrid = সঙ্কর
hyperactive = অতিসক্রিয়
hypocrite = ভন্ড
hypothesis = অনুমান
hypothetical = কাল্পনিক
i = আমি
identify = সনাক্ত করা
ignore = উপেক্ষা করা
imagine = কল্পনা করা
implement = বাস্তবায়ন করা
impose = আরোপ করা
improve = উন্নতি করা
inaugurate = আনুষ্ঠানিকভাবে উদ্বোধন করা
include = অন্তর্ভুক্ত করা
indicate = নির্দেশ করা
inform = জানা
infuse = পরিপৃক্ত করা
inherit = উত্তরাধিকারসূত্রে পা
init = চালু করা
initialize = চালু করা
injure = আহত করা
insert = ভিতরে ঢোকান
inspect = পরিদর্শন করা
inspire = অনুপ্রাণিত করা
install = ইনস্টল করা
intensify = জোরদার করা
interlace = ইন্টারলেস করা
interrupt = ধারাবাহিকতা ভঙ্গ করা
introduce = উপস্থাপন করা
invert = বিপরীত অবস্থায় আন
involve = সংশ্লিষ্ট করা
idealist = ভাববাদী
ignored = উপেক্ষিত
implemented = বাস্তবায়িত
independent = স্বাধীন, স্বাবলম্বী
india = ভারত
indian = ভারতীয়
infinite = অসীম
instance = ঘটনা, দৃষ্টান্ত
insurgent = বিদ্রোহীমধ্যে
introduced = উত্থাপিত
invited = আমন্ত্রিত
iodine = আয়োডিন
ion = আয়ন
ionic = আয়নিক
islamic = ইসলাম সম্বন্ধীয়
isomar = আইসোমার
isotone = আইসোটোন
isotope = আইসোটোপ
iteratively = পুনরাবৃত্তভাবে
improper = অনুচিত
in = মধ্যে
incorrectly = ভুলভাবে
info = তথ্য
infos = তথ্যাদি
infotech = তথ্যপ্রযুক্তি
inhabitant = বাসিন্দা
initialization = চালুকরণ
inrtellectual = পন্ডিত
instead = ব্যতীত
item = বস্তু
ice = বরফ
ice = বরফ
icebox = বরফের বাক্স
icon = আইকন
icons = আইকনস্
icy = বরফ-শীতল
idea = ধারনা
ideal = আদর্শ
idealism = ভাববাদ
ideally = আদর্শভাবে
identical = অনুরূপ
identification = পরিচয়
identifier = চিহ্নিত
identify = সনাক্ত করা
identity = পরিচয়
idle = অলস
idol = প্রতিমা
idolize = আরাদ্ধ বস্তুতে পরিণত করা = দেবতা জ্ঞানে পুজা করা
if = যদি
ignorance = অবহেলা
ignore = উপেক্ষা
ignoring = উপেক্ষা করছে
ill = অসুস্থ
ill = অসুস্থ
illegal = বেআইনি
illness = অসুস্থতা
illusion = মরীচিকা
illustrate = অলংকরণ করা
illustrates = আঁকা
illustration = অলংকরণ
illustrator = আঁকিয়ে
image = চিত্র
image = ছবি
images = চিত্র
imagination = কল্পনা
imagine = কল্পনা করা
imbibe = পান করা
imitate = নকল করা
immeasurable = অপরিমেয়
immediate = অবিলম্বে
immediately = তাৎ‍ক্ষণিকভাবে
immensely = প্রকান্ডভাবে
immigrant = অভিবাসী
immigrants = অভিবাসী
imminent = আসন্ন
imminently = সমুপস্হিতরুপে
immune = অনাক্রম্য
immune.sSstem = অনাক্রম্য সিস্টেম
immutable = অপরিবর্তনীয়
impact = ধাক্কা
impact = ধাক্কা দেওয়া
impaired = দুর্বল
impatient = অধৈর্য
impatient = অধীর
imperialist = সাম্রাজ্যবাদী
implement = বাস্তবায়ন
implementation = বাস্তবায়ন
implicit = পরোক্ষ
imply = ইঙ্গিত করা
impolite = অভদ্র
import = আমদানি
import = আমদানি করা
importance = গুরুত্ব
important = গুরুত্বপূর্ণ
importantly = গুরুত্বপূর্ণভাবে
imported = আমদানীকৃত
importing = আমদানি করা হচ্ছে
impose = আরোপ করা
imposed = আরোপিত
imposing = চিত্তাকর্ষক
impossible = অসম্ভব
impossibly = অসম্ভবভাবে
impregnable = অভেদ্য
impress = রেখাপাত করা
impressionist = রূপবাদী চিত্রকর
imprisoned = বদ্ধ
imprisonment = গারদ
improper = বেঠিক
improperly = অসঙ্গতভাবে
improve = উন্নতি করা
improved = উন্নত
improvement = উন্নতি
improvements = উন্নতি
improving = উন্নতিশীল
impure = দূষিত
inaccurate = বেঠিক
inactivate = নিষ্ক্রিয় করা
inactive = নিষ্ক্রিয়
inadequate = অপর্যাপ্ত
inappropriate = বেমানান
inauguration = উদ্বোধন
incalculable = অপরিমেয়
incapable = অক্ষম
incapable = অযোগ্য
incentive = উদ্দীপনা
incest = আত্মীয়ের মধ্যে শারীরিক মিলন
inch = ইঞ্চি
inches = ইঞ্চি
incident = ঘটনা
incidental = প্রাসঙ্গিক
incidentally = ঘটনাক্রমে
incipience = সৃষ্টি
incitement = উত্তেজনা
inclination = নতি
include = অন্তর্ভুক্ত করা
included = অন্তর্ভুক্ত
includes = অন্তর্ভুক্ত
including = সহ
inclusion = অন্তর্ভুক্তি
incoherent = খাপ-ছাড়া
income = আায়
incoming = আগমনরত
incoming = অন্তর্মুখী
incompatibility = অসঙ্গতি
incompatible = সামঞ্জস্যহীন
incompetent = অযোগ্য
incomplete = অসম্পূর্ণ
incompletely = অসম্পূর্ণভাবে
incompleteness = অপরিপূর্ণতা
inconsiderable = অবিবেচ্য
inconsistent = খাপ-ছাড়া
inconvenience = অসুবিধা
inconvenient = অসুবিধাজনক
incorporated = একত্রীভূত
incorrect = বেঠিক
incorrectly = বেঠিকভাবে
increase = বৃদ্ধি
increase = বৃদ্ধি করা
increased = অধিক
increases = বৃদ্ধি
increasingly = ক্রমবর্ধমানভাবে
incredible = অবিশ্বাস্য
incredulity = অবিশ্বাস
incremental = ক্রমবর্ধিষ্ণু
indeed = বাস্তবিকপক্ষে
indefinite = অনির্দিষ্ট
indefinitely = অনির্দিষ্টভাবে
independence = স্বাধীনতা
independent = নিরপেক্ষ
independent = স্বাধীন
independently = স্বাধীনভাবে
indeterminate = অনির্ণীত
index = সূচিপত্র
indicate = নির্দেশ করা
indicated = নির্দেশিত
indicates = নির্দেশ করে
indication = ইঙ্গিত
indicator = নির্দেশক
indicators = নির্দেশক
indict = অভিযুক্ত করা
indirect = পরক্ষ
indispensable = অপরিহার্য
individual = ব্যক্তিগত
individually = নিজস্বভাবে
indivisible = অবিভাজ্য
industrial = শ্রমশিল্পসংক্রান্ত
industries = শ্রমশিল্প
industry = শিল্প
inedible = অখাদ্য
ineptness = অসারতা
inertia = জড়তা
inexact = বেঠিক
inexpensive = সস্তা
infamous = কুখ্যাত
infant = শিশু
infatuation = মোহ
infect = সংক্রামিত করা
infected = সংক্রামিত
infectious = সংক্রামক
infer = অনুমান করা
inferable = অনুমেয়
inference = অনুসিদ্ধান্ত
inferential = অনুমানসিদ্ধ
infertile = অনুর্বর
infinite = অনন্ত
infinitesimal = ক্ষুদ্রাদপিক্ষুদ্র
infinity = অসীম
inflation = মুদ্রাস্ফীতি
inflict = প্রদান করা
inflow = অন্তঃপ্রবাহ
influence = প্রভাব
influence = প্রভাবিত করা
influential = প্রভাবশালী
influenza = ইনফ্লুয়েঞ্জা
inform = জানানো
informally = অনানুষ্ঠানিক ভাবে
information = তথ্য
informational = তথ্যভুল
informs = জানায়
infrared = অবলোহিত
infrastructure = পরিকাঠামো
infringement = বিধিলঙ্ঘন
infuse = পরিপৃক্ত করা
ingredient = উপকরণ
inherit = উত্তরাধিকারসূত্রে পাওয়া
inherited = উত্তরাধিকার সুত্রে প্রাপ্ত
inhibitor = দমনকারী
inimitable = অননুকরণীয়
initial = প্রাথমিক
initialize = চালু করা
initialized = সচল
initializing = চালু করা
initially = প্রাথমিকভাবে
initiate = চালুকরণ
initiative = প্রবর্তন
injure = আহত করা
injure = আহত করা
injured = আহত
injury = আঘাত
injustice = অবিচার
ink = কালি
inmate = বাসিন্দা
innate = সহজাত
inner = অভ্যন্তরীণ
innings = ইনিংস
innocent = নির্দোষ
innovate = নতুন কিছুর প্রবর্তন করা
innovation = উদ্ভাবন
innovations = উদ্ভাবন
innovative = প্রবর্তক
input = ইনপুট
inquiry = অনুসন্ধান
insect = পতঙ্গ
insecticide = কীটনাষক
insensitive = অসংবেদী
insert = ঢোকানো
insert = ভিতরে ঢোকান
inserted = সন্নিবেশিত
insertion = ঢোকানো
inside = অভ্যন্তরে
inside = ভেতরে
insight = পরিজ্ঞান
insignificant = তুচ্ছ
insinuation = ধীরে ধীরে সুকৌশলে অভ্যন্তরপ্রবেশ = বক্রোক্তি
insist = পিড়াপিড়ি করা
insistent = জেদি
inspect = পরিদর্শন করা
inspect = পরিদ‌র্শন করা
inspection = পরিদর্শন
inspiration = প্রেরণা
inspire = অনুপ্রাণিত করা
inspired = অনুপ্রেরিত
instability = অস্থিরতা
install = ইনস্টল
installation = ইনস্টলেশন
installed = ইনস্টল করা আছে
installed = ইনস্টলকৃত
installer = ইনস্টলার
installment = কিস্তি
instance = উদাহরণ
instances = উদাহরণ
instant = তাৎক্ষণিক
instant = মুহূর্ত
instantly = তাৎক্ষনিকভাবে
instead = পরিবর্তে
instinctual = সহজাতপ্রবৃত্তি-জনিত
institute = সংস্থা
institutes = সংস্থা
institution = সংস্থা
instruction = নির্দেশনা
instructions = নির্দেশাবলী
instrument = যন্ত্র
instrumentally = যান্ত্রিকভাবে
instruments = যন্ত্র সমূহ
insufficient = অপর্যাপ্ত
insult = অপমান
insult = অপমান করা
insurgency = বিদ্রোহ
insurgent = বিদ্রোহ
intangible = অলীক
intangible = অলীক
integer = পূর্ণসংখ্যা
integral = অখন্ড
integration = একত্রীকরণ
integrity = শুদ্ধতা
intellectual = বুদ্ধিজীবি
intellectually = বুদ্ধিমত
intelligence = মেধা
intelligent = মেধাবী
intelligentsia = বুদ্ধিজীবী-সম্প্রদায়
intend = মনস্থ করা
intended = উদ্দেশ্যে
intensify = জোরদার করা
intensity = তীব্রতা
intensive = তীব্র
intensive = প্রগাড়
intent = উদ্দেশ্য
intention = অভিপ্রায়
intentionally = ইচ্ছাকৃত
inter = আন্ত
interaction = পারস্পরিক যোগাযোগ
interactions = মিথষ্ক্রিয়া
intercept = ধাওয়া করা
interchange = বিনিময়
intercity = আন্তঃশহর
interconnect = পরস্পরের মধ্যে সংযোগ সাধন করা
intercourse = যৌন-সহবাস
interest = আগ্রহ
interested = কৌতূহলী
interesting = উৎসাহজনক
interface = ইন্টারফেস
interfaces = ইন্টারফেস
interim = অন্তর্বর্তীকালীন
interior = অভ্যন্তরীণ
interlude = গর্ভাভিনয়
intermediate = মধ্যবর্তী
internal = অভ্যন্তরীণ
internally = অভ্যন্তরীণভাবে
international = আন্তর্জাতিক
internationalization = আন্তর্জাতিকীকরণ
internationally = আন্তর্জাতিকভাবে
interplay = মিথস্ক্রিয়া
interpret = ব্যাখ্যা করা
interrogate = জিজ্ঞাসাবাদ করা
interrupt = মাঝপথে বাধা দেওয়া
interruption = মাঝপথে বাধা দেওয়া
intersect = পরস্পর ছেদ করা
interval = বিরতি
interview = সাক্ষাৎকার
intestine = অন্ত্র
intimation = অন্তরঙ্গতা
intimidate = ভয় দেখান
into = মধ্যে
into = মধ্যে
intonation = কথা বলার সময় কন্ঠস্বরের ওজনের উত্থান-পতন
introduce = উপস্থাপন
introduction = ভূমিকা
intrusive = অনধিকার প্রবেশমূলক
institution = প্রতিষ্ঠান
intuitive = স্বতঃস্ফুর্ত
invader = হানাদার
invaders = হানাদার
invalid = অবৈধ
invalid = ত্রুটিযুক্ত
invalid = বেঠিক
invaluable = অমূল্য
invariable = অপরিবর্তনীয়
invariably = অপরিবর্তনীয়ভাবে
invariant = অপরিবর্তনীয়
invent = উদ্ভাবন করা
invention = উদ্ভাবনা
inverse = বিপরীত
inverse = বিপরীত
inversely = বিপরীতক্রমে
invert = বিপরীত অবস্থায় আনা
invest = বিনিয়োগ করা
investigation = তদন্ত
investigator = তদন্তকারী
investment = বিনিয়োগ
investment = বিনিয়োগ
invincible = অজেয়
invisible = অদৃশ্য
invitation = আমন্ত্রণ
invite = আমন্ত্রণ করা
involve = অন্তর্ভুক্ত
involve = জড়িত করা
inward = ভিতরের দিকে
ionized = আয়নিত
ionosphere = আয়নমণ্ডল
ip = অাই.পি.
irk = বিরক্ত করা
irregular = অনিয়মিত
irrelevant = খাপ-ছাড়া
irrepressible = অদম্য
irresistable = দুর্দম
irresistibly = অপ্রতিরোধ্যভাবে
irretrievably = অপূরণীয়ভাবে
irreversibly = চিরতরে
irrigate = জল সেচ করা
irritate = জ্বালাতন করা
island = দ্বীপ
islands = দ্বীপপুঞ্জ
isocyanate = আইসো-সায়ানেট
isolated = বিচ্ছিন্ন
issue = বিষয়
issue = প্রচার করা
it = এটা
italics = ইটালিক
itch = চুলকানো
itchy = চুলকায় এমন
item = পদ
items = পদগুলো
items = বস্তু
its = তার
jacket = জ্যাকেট
jagged = অসমতল ভুমি = খাঁজ কাটা
jail = জেল
jail = কারারুদ্ধ করা
jailed = জেলবন্দী
jailhouse = জেলখানা
jam = ঠাসাঠাসি করা
jar = জার
java = জাভা
jaw = চোয়াল
jawbone = চোয়াল
jealousy = জ্বলন
jellyfish = জেলিফিশ
jest = পরিহাস
jetty = জাহাজঘাটা
jewel = রত্ন
jeweler = জহুরী
jinx = অপয়া
job = কাজ
jobs = কর্ম
jocular = রসিক
john = জন
join = যুক্তকরণ
joining = যুক্ত করা
joint = যৌথ
joke = কৌতুক
joke = পরিহাস করা
joke = ঠাট্টা করা
jokingly = পরিহাসভরে
jolly = প্রফুল্ল
journalism = সাংবাদিকতা
journalist = সাংবাদিক
journalistic = সাংবাদিকসুলভ
jovial = আমুদে
joyful = আনন্দময়
jubilation = আনন্দোৎসব
judgement = বিচার
judgment = বিচার
judicial = বিচার বিষয়ক
judiciary = বিচারবিভাগ
juiciest = রসালো
juicy = রসাল
jump = লাফান
jump = লাফান
jumps = লাফ দেয়
jungle = ক্রান্তীয় অরণ্য
jurisdiction = অধিকারভুক্ত অঞ্চল
just = শুধু
just = মাত্র
justice = সুবিচার
justification = ন্যায্যতা
justified = বিন্যাসকৃত
justify = সমর্থন করা
justness = যথার্থতা
jute = পাট
juxtaposition = সহাবস্থান
join = যোগদান করা
kamikaze = আত্মঘাতী
keep = রাখা
keep = রাখা
keeping = রাখছে
kernel = কার্নেল
kerosene = কেরোসিন তেল
key = মূখ্য
key = চাবি
keyboard = কীবোর্ড
kidnap = অপহরণ করা
kidney = কিডনি
kill = হত্যা করা
kill = হত্যা করা
killer = খুনি
killing = হত্যা
killings = হত্যা
kilogram = কিলোগ্রাম
kilometer = কিলোমিটার
kin = জ্ঞাতিবর্গ
kind = ধরন
kind = দয়ালু
kinetic = গতি
kings = রাজা
kiosk = কিয়স্ক
kiss = চুম্বন
kiss = চুম্বন করা
kit = কিট
kitchen = রান্নাঘর
kite = ঘুড়ি
know = জানা
know = জানা
knowingly = জানামতে
knowledge = জ্ঞান
known = পরিচিত
known = জ্ঞাত
knows = জানে
keep up = বজায় রাখ
kidnap = অপহরণ করা
larger = বৃহত্তর
largest = বৃহত্তম
lazy = অলস
lesbian = সমকামী
less = কম
lichi = লিচু
line = লাইন
liquid = তরল
litmus = লিটমাস
loading = লোড করা হচ্ছে
localised = স্থানীয়ভাবে সীমাবদ্ধ
longest = দীর্ঘতম
layout = নকশা
legal = বৈধ
letterbox = চিঠির বাক্স
licence = লাইসেন্স
local time = স্থানীয় সময়
learn = শেখা
leave.oOt = বাদ দেওয়া
leave = ছেড়ে চলে যাওয়া
lend = ধার দেওয়া
link = সংযোগ করা
listen = শোনা
locate = অবস্থান নির্ণয় করা
log in = লগিন করা
log on = লগ-ওন করা
log out = প্রস্থান করা
log = কার্যবিবরণী লেখা
look.aAter = দেখা শুনা করা
loop = চক্রাকারে ঘোরা
lose = হারা
la = লা
lab = গবেষণাগার
label = লেবেল
labels = লেবেল
labor = শ্রম
laborer = শ্রমিক
labour = শ্রম
lack = অভাব
lack = অভাব
lacquer = সোনালী বার্নিশ
lad = কিশোর
ladder = মই
lake = হ্রদ
lamb = ভেড়া
lamp = দীপ
land = জমি
land = অবতরণ করা
landing = অবতরন করা
landlord = বাড়ির মালিক
landmark = পথনির্দেশক চিহ্ন
landowner = জায়গার মালিক
landslide = ধস
language = ভাষা
languages = ভাষা
languid = অবসন্ন
lapsed = বাতিল
larceny = চুরি
large = বড়
largely = প্রধানত
larger = বৃহত্তর
laser = লেসার
last = শেষ
lasting = স্থায়ী
late = দেরি
late = শেষ
latent = সুপ্ত
later = পরে
later = পরবর্তী কালে
latest = সাম্প্রতিক
latex = লেটেক্স
latitude = অক্ষাংশ
latter = শেষোক্ত
laugh = পরিহাস করা
laughs = হাসা
laughter = হাসি
launch = চালু
launch = চালু করা
lava = লাভা
law = আইনকানুন
laws = আইনকানুন
lawyer = আইনজীবি
lawyers = উকিল
layer = স্তর
layering = স্তরে স্তরে
layout = ছক
lazy = অকর্মণ্য
lead = প্রধান
lead = নেতৃত্ব
lead = নেতৃত্ব দেওয়া
leader = নেতা
leadership = নেতৃত্ব
leading = প্রধান
leading = নেতৃত্বদান
leaf = পাতা
league = লীগ
leak = ফাঁস
leap = লাফান
learn = শেখা
learned = বিজ্ঞ
lease = লীজ দেওয়া
leash = নিয়ন্ত্রণ করা
least = অন্তত
leave = সাময়িক ছুটি
leave = বাদ
leaving = ত্যাগ করছে
ledger = লেজার
left = বাকি আছে
left = বাম
left = বামপার্শ্ব
leg = পা
legacy = উত্তরাধিকারসূত্রে প্রাপ্ত সম্পত্তি
legal = আইনি
legally = আইনত
legation = পোপের দূত প্রেরণ
legend = প্রতিক চিহ্ন
legends = কিংবদন্তী
legislation = আইন
legislative = আইন প্রণয়নের অধিকার প্রাপ্ত
legislator = বিধায়ক
legislature = আইনসভা
legitimacy = ন্যায্যতা
legitimate = বৈধ
legume = শিম
leisure = অবকাশ
lend = ধার
length = দৈর্ঘ্য
lesson = পাঠ
lessons = পাঠ
let = দেওয়া
letter = চিঠি
level = ধাপ
level = মাত্রা
level = স্তর
levels = স্তর
lever = লিভার
levy = কর ধার্য করা
lexicon = অভিধান
liability = বাধ্যবাধকতা
liable = দায়ী
liar = মিথ্যাবাদী
libel = লিখিত কুৎসা
liberal = উদারনৈতিক
liberally = উদারভাবে
liberation = স্বাধীনতা
liberty = স্বাধীনতা
libido = যৌনতা
library = লাইব্রেরী
license = লাইসেন্স
license = লাইসেন্স দেওয়া
licensing = লাইসেন্স প্রদান
lie = অবস্থান করা
life = জীবন
lifelong = জীবন-ব্যাপী
lifes = জীবন
lifestyle = জীবনযাত্রা
lifetime = জীবনকাল
lift = উত্তোলন করা
light = জ্বালানো
light.yYar = আলোকবর্ষ
lighten = আলোকিত করা
lighter = হালকাতর
lightest = হালকাতম
lightly = হালকা ভাবে
lightness = উজ্জ্বলতা
lightning = বজ্রপাত
lightweight = হালকা
lightweight = হালকা
like = অনুরূপ
like = মত
likely = সম্ভাব্য
liking = ঝোঁক
lime = চুন
limit = সীমা
limit = সীমাবদ্ধ করা
limitation = সীমাবদ্ধতা
limited = সীমিত
limited = সীমাবদ্ধ
limits = সীমা
limits = সীমা
line = সারি
line = লাইন দেওয়া
linear = রৈখিক
link = লিঙ্ক
link = সংযোগ
linked = সংযুক্ত
linking = যুক্তকরণ
links = লিঙ্ক
linkup = সংযোগ
lion = সিংহ
lip = ঠোঁট
lips = ঠোট
list = তালিকা
list = তালিকাভুক্ত করা
listed = তালিকাভুক্ত
listen = শোন
listener = শ্রোতা
listeners = শ্রোতা
listening = শুনছে
listing = তালিকা
lists = তালিকা
literate = শিক্ষিত
literature = সাহিত্য
little = ছোট
live = বসবাস করা
live = বসবাস করা
livelihood = জীবনযাপন
liveliness = সজীবতা
liver = যকৃৎ
lives = বসবাস করা
livestock = গৃহপালিত পশু
living = জীবনযাপন
living = জীবিত
lizard = টিকটিকি
lo = এল-ও
load = লোড
load = লোড করা
loaded = লোডকৃত
loader = লোডার
loan = ধার দেয়া
loath = ঘৃণা করা
local = স্থানীয়
locale = লোকেল
localities = স্থান
locality = স্থান
locally = স্থানীয়ভাবে
locate = অবস্থান নির্দেশ
located = অবস্থিত
location = অবস্থান
locations = অবস্থান
lock = লক
lock = লক করা
locked = লককৃত
locking = লক করা হচ্ছে
lockup = গারদ
locomotive = রেল ইজ্ঞিন
locomotives = রেল ইজ্ঞিন
log = কার্যবিবরণী
log = লগ
log = লিপিবদ্ধকরণ
logarithm = লগারিদম
logging = লগ লেখা
logic = যুক্তি
logical = যৌক্তিক
logo = প্রতীক
lone = নির্জন
lonelier = একাকী
lonely = একাকী
long = দীর্ঘ
long = লম্বা
long.dDstance = দুরপাল্লা
longer = দীর্ঘতর
longitude = দ্রাঘিমাংশ
longitudinal = দ্রাঘিমাগত
look = দেখা
looking = দেখ
looks = চেহারা
lookup = অনুসন্ধান
loop = চক্র
loose = আলগা
loosely = আলগাভাবে
loosen = আলগা হওয়া
lose = হারান
loss = ক্ষতি
lost = হারানো
lot = অনেক
lots = অনেক
lotus = পদ্ম
loud = প্রবল
loudly = উচ্চস্বরে
lousy = উকুনময়
lovable = ভালবাসার যোগ্য
love = ভালোবাসা
lover = প্রেমিক
loving = মনোরম
low = অল্প
low = নিম্ন
lower = নিম্নতর
lower = ছোট হাতের
lower = নিম্নস্তরীয়
lower = নিম্নতর
lowest = সর্বনিম্ন
luck = ভাগ্য
luckily = ভাগ্যক্রমে
lucky = ভাগ্যবান
lucrative = লাভজনক
lunar = চান্দ্র
lunatic = খ্যাপা
lunch = মধ্যাহ্নভোজন করা
lung = ফুসফুস
lure = প্রলোভন
lurk = ওঁত পেতে থাকা
lush = পরিপূর্ণভাবে বর্ধিত
lust = যৌনসঙ্গকামনা
luxurious = বিলাসবহুল
lyrics = গানের কথা
machine = মেশিন
mad = পাগল
made = তৈরী
made = প্রস্তুত
madly = পাগলের মত
madness = পাগলামি
magazine = ম্যাগাজিন
magazines = সাময়িক পত্রিকা
magenta = ম্যাজেন্টা
magic = জাদু
magician = জাদুকর
magnet = চুম্বক
magnetism = চৌম্বকত্ব
magnitude = মান
mail = মেইল
mailbox = ডাকবাক্স
mailboxes = মেইলবাক্স
main = প্রধান
mainly = প্রধানত
mainstream = মূলধারা
mainstream = মূলস্রোত
maintain = রক্ষণাবেক্ষণ
maintained = রক্ষণাবেক্ষণকৃত
maintenance = রক্ষণাবেক্ষণ
majestic = রাজকীয়
majestically = রাজকীয়ভাবে
major = প্রধান
majority = সংখ্যাগুরু
make = তৈরি করা
make = তৈরী করা
make = বানানো
makeover = বদলী রূপ
maker = প্রস্তুত কারক
makes = তৈরি করে
making = তৈরি করা
malaise = অসুখ
malaria = ম্যালেরিয়া
male = পুরুষ
malformed = বিকৃত
mall = বিপণী বিতান
malnourishment = অপুষ্টি
maltreatment = দুর্ব্যবহার
manage = পরিচালনা করা
manageable = সামলানোরযোগ্য
management = ব্যবস্থাপনা
manager = ব্যবস্থাপক
managing = কার্যনির্বাহী
mandate = জনাদেশ
mandatory = আবশ্যিক
manhood = পূর্ণ বয়স = যৌবন
manifestly = প্রকটভাবে
manipulate = নিপুণভাবে ব্যবহার করা
manipulation = পরিবর্তন করা
mankind = মানব জাতি
manna = পবিত্র খাদ্য
manner = পদ্ধতি
manservant = চাকর
manual = নিজে হাতে
manual = সহায়িকা
manually = নিজহাতে
manufacture = উৎ‍পাদন
manufacture = উৎ‍পাদন করা
manufacturer = প্রস্তুতকারক
manufacturing = উৎ‍পাদন
manure = সার
many = অনেক
many = অনেক
many = অনেক
map = মানচিত্র
map = ম্যাপ করা
mapped = ম্যাপকৃত
mapping = ম্যাপ কর
marble = মার্বেল
march = মার্চ
margin = মার্জিন
margins = মার্জিন
marijuana = গাঁজা
marine = নৌসেনা
marital = বৈবাহিক
mark = চিহ্ন
mark = চিহ্নিত করা
marked = চিহ্নিত
marked = নির্দিষ্টকৃত
markers = চিহ্ন
market = বাজার
market = কেনাকাটা করা
marketing = বিপণন
markets = বাজার
marks = চিহ্ন
markup = মার্কআপ
marooned = পরিত্যক্ত
marriage = বিবাহ
married = বিবাহিত
marry = বিয়ে করা
marshal = শান্তিরক্ষা
martyr = শহীদ
mask = মুখোস
mason = রাজমিস্ত্রি
mass = ভর
massacre = গণহত্যা
massacre = গণহত্যা করা
massive = বিরাট
master = মাষ্টার
master = মাস্টার করা
match = মিল
matches = মিল
matching = অনুরূপ
matchmaker = ঘটক
mate = সহচর
mate = সঙ্গী
material = উপকরণ
material = সামগ্রী
materialism = বস্তুবাদ
materialistic = বস্তুবাদী
materials = উপকরণ
math = অংক
mathematical = গাণিতিক
mathematics = গণিত
matrimonial = বৈবাহিক
matrix = ম্যাট্রিক্স
matter = বিষয়বস্তু
matter = গুরুত্বপূর্ণ হওয়া
matters = বিষয়
maturity = পূর্ণতা
max = সর্বোচ্চ
maximal = সর্বোচ্চ
maximize = বড় করা
maximize = যথাসম্ভব বড় করো
maximum = সর্বোচ্চ
maximum = সর্বাধিক
may = হয়ত
may = মে
maybe = হয়ত
mayhem = ধংসযজ্ঞ
me = আমি
me = আমি
mean = নীচ
meaning = অর্থ
meaningful = অর্থপূর্ণ
meaningless = অর্থহীন
means = পদ্ধতি
meanwhile = ইতিমধ্যে
measure = পরিমাপ
measure = পরিমাপ করা
measure = পরিমাপ করা
measurement = পরিমাপ
measures = পরিমাপ
meat = মাংস
mecca = মক্কা
mechanism = কৌশল
medal = পদক
media = মিডিয়া
median = মধ্যমা
mediate = মধ্যস্থতা করা
mediator = মধ্যস্থতাকারী
medical = চিকিৎসা-শাস্ত্রগত‌
medication = ঔষধ
medicine = ঔষধ
medium = মাঝারি
medium = মাধ্যম
meet = েদখা করা
meet = দেখা করা
meeting = মিটিং
megabyte = মেগাবাইট
megabytes = মেগাবাইট
melancholy = বিষণ্ণতা
melanin = মেলানিন
melodrama = অতিনাটক
melody = সুতান
melt = গলানো
melt = গলান
melting = গালন
member = সদস্য
members = সদসবৃন্দ
membership = সদস্যপদ
membrane = পর্দা
memo = মেমো
memorandum = স্মারকলিপি
memorial = স্মৃতিচিহ্ন
memorials = স্মৃতিচিহ্ন
memory = মেমরি
mental = মানসিক
mentally = মানসিকভাবে
mention = উল্লেখ
mention = উল্লেখ করা
mentioned = উল্লেখকৃত
menu = মেনু
menus = মেনু
merchant = ব্যবসায়ী
mercury = পারদ
mercy = মাফ দেওয়া
mere = সাধারণ
merely = নিছক
merge = নিমজ্জিত করা
merge = নিমজ্জিত করা
merged = একীভূত
merger = একত্রীকরণ
merit = যোগ্যতা
merriment = আনন্দ
merry = খুশী
message = তথ্য
messages = বার্তা
messenger = বার্তাবাহক
metabolic = বিপাকীয়
metal = ধাতু
metallic = ধাতব
metaphysical = অধিবিদ্যক
metaphysics = অধিবিজ্ঞান
meteor = উল্কা
meteorite = উল্কাপিণ্ড
metered = মিটার
method = পন্থা
methylene = মিথাইলিন
metre = মিটার
metro = মেট্রো
metropolis = মহানগর
metropolitan = মেট্রোপলিটান
mica = অভ্র
mice = ইঁদুর
micro = মাইক্রো
microorganism = অণুজীব
microscopic = আনুবীক্ষণিক
microwave = মাইক্রোওয়েভ
mid = মাঝামাঝি
midday = মধ্যাহ্ণ
middle = মধ্য
midlevel = মাঝারি
midnight = মধ্যরাত্রি
midpoint = মধ্যবিন্দু
midwife = ধাত্রী
might = ক্ষমতা
migrant = অভিবাসী
mild = মৃদু
mile = মাইল
miles = মাইল
milion = দশ লক্ষ
militancy = উগ্রপন্থা
militant = উগ্রপন্থী
military = সামরিক
militia = রক্ষীবাহিনী
milk = দুধ
milk = দোহন করা
millennium = সহস্রাব্দ
milliliter = মিলি-লিটার
millimeters = মিলিমিটার
million = দশ লক্ষ
millisecond = মিলি সেকেন্ড
min = মিনিট
mind = মন
mind = অভিমান করা
mine = আমার
mine = আমার
miner = খনি-শ্রমিক
minimal = সর্বনিম্ন
minimize = আড়াল করা
minimum = ন্যুনতম
minimum = সর্বনিম্ন
minincomputer = ছোট কম্পিউটার
miniscule = ক্ষুদ্র
minister = মন্ত্রী
ministers = মন্ত্রী
ministry = মন্ত্রণালয়
minor = মাইনর
minority = সংখ্যালঘু
minority = সংখ্যালঘু
minus = বিয়োগ
minus = বাদে
minute = মিনিট
minutes = মিনিট
miracle = অলৌকিক ঘটনা
miracles = অলৌকিক ঘটনা
miraculous = অলৌকিক
mirror = আয়না
mirror = আয়না
mirrors = আয়না
mirth = আনন্দোচ্ছ্বাস
misbehavior = অশোভন আচরণ
miscellaneous = বিবিধ
miserly = বদ্ধমুষ্টি
mishap = দুর্ঘটনা
misinformation = ভুল তথ্য
mismatch = অমিল
misquotation = ভুল উদ্ধৃতি
miss = লক্ষ্যভ্রষ্ট হওয়া
miss = লক্ষ্যভ্রষ্ট হওয়া
missile = ক্ষেপণাস্ত্র
missing = নিখোঁজ
missing = নিরুদ্দেশ
mission = লক্ষ্য
misspelled = ভুল বানান
mistake = ভূল
mistakes = ভূল
mistreat = দুর্ব্যবহার করা
mistress = গৃহিণী
mistrust = অবিশ্বাস করা
misunderstand = ভুল বোঝা
misunderstanding = ভূল বোঝাবুঝি
mix = মিশ্র
mix = মিশ্রিত করা
mixed = মিশ্র
mm = মিমি
mnemonic = স্মৃতি-সহায়ক
moan = বিলাপ করে কথা বলা
mobile = চলমান
mock = পরিহাস করা
mockery = পরিহাস
mode = অবস্থা
mode = মোড
model = মডেল
model = নমুনা তৈরি করা
modem = মোডেম
modems = মোডেম
moderate = পরিমিত
moderate = মাঝারি
modern = আধুনিক
modes = মোড
modification = পরিমার্জন
modified = পরিবর্তিত
modify = পরিবর্তন
modifying = পরিবর্তন করা হচ্ছে
modulation = মডিউলেশন
module = মডিউল
modules = মডিউল
moist = আর্দ্র
moisture = আর্দ্রতা
molar = মোলার
molecular = আণবিক
mom = মা
moment = মূহুর্ত
monarch = রাজা
monarchy = রাজতন্ত্র
money = অর্থ
monitor = পর্যবেক্ষণ করা
monkey = বানর
mono = মোনো
monochrome = একবর্ণী
monopoly = একচেটিয়া অধিকার
monotonous = একঘেয়ে
monsoon = বর্ষাকাল
month = মাস
monthly = মাসিক
months = মাস
monument = স্মৃতিসৌধ
monuments = স্মৃতিসৌধ
moonlight = জোৎস্না
moral = নৈতিক
morale = আত্মবিশ্বাস
more = আরও বেশি
more = আরো
more = বেশি
more = আরও বেশি
more = বেশী
more.oO.lLss = আন্দাজ
morphine = বেদনা নাশক ঔষধ
mosque = মসজিদ
mosquito = মশা
most = বেশীরভাগ
most = সর্বাপেক্ষা
mostly = বেশির ভাগ
moth = মথ
mother = জননী
motif = মোটিফ
motion = গতি
motivation = অনুপ্রেরণা
motivations = অনুপ্রেরণা
motive = উদ্দেশ্য
mould = ছাঁচে তেরি করা
mount = মাউন্ট করা
mountain = পর্বত
mounted = মাউন্টকৃত
mounting = মাউন্ট করা
mourn = শোকপালন করা
mournfully = শোকার্তভাবে
mourning = শোক
mouse = মাউস
mouth = মুখ
move = চাল
move = দান
move = সরানো
movement = চলাচল
movements = আন্দোলন
movie = চলচ্চিত্র
movies = চলচ্চিত্র
moving = চলন্ত
moving = চলন্ত
mph = মাইল প্রতি ঘন্টা
much = অধিক
much = বেশি
muffler = গলাবন্ধ
mug = মগ
mule = খচ্চর
multi = মাল্টি
multimedia = মাল্টিমিডিয়া
multinational = বহুজাতিক
multipart = বহুখন্ড
multiple = একাধিক
multiply = বংশবৃদ্ধি করা
multiply = বৃদ্ধি পাওয়া
multipurpose = বহুমুখী
municipal = পৌরসভা সম্বন্ধীয়
municipality = পুরসভা
munitions = যুদ্ধোপকরণ
murderous = খুনে
muscle = পেশী
museum = জাদুঘর
mushroom = ছত্রাক
mushroom = ছত্রাক
music = সঙ্গীত
musical = সুরেলা
musk = মুখোশ
must = অবশ্যই
mustard = সরিষা
mute = নীরব
mute = নীরব করা
muted = নীরবকৃত
mutiny = বিদ্রোহ
mutter = বিড় বিড় করা
mutton = ভেড়ার মাংস
mutual = পারস্পরিক
myriad = অগণ্য
myself = স্বয়ং আমি
mysterious = রহস্যময়
mysteriously = রহস্যজনকভাবে
mystery = রহস্য
mystical = রহস্যজনক
mythology = পুরান
nadir = কুবিন্দু
nail = নখ
naked = উলঙ্গ
name = নাম
name = নাম করা
named = নামাঙ্কিত
names = নামগুলো
namesake = এক নামের লোক
napkin = গামছা
narrative = বর্ণনামূলক
narrative = ধারাবাহিক বর্ণনা
narrow = সরু
narrowly = অল্পের জন্য
nascent = জায়মান
nation = জাতি
national = জাতীয়
nationalise = জাতীয় সম্পত্তিতে পরিণত করা
nationalist = জাতীয়তাবাদী
nationality = জাতীয়তা
native = স্থানীয়
natural = প্রাকৃতিক
naturally = স্বাভাবিকভাবে
nature = প্রকৃতি
natured = স্বভাবসম্পন্ন
nausea = বমি-বমি ভাব
nauseated = বিরক্ত
naval = নৌ
navigate = পরিক্রমণ
navigation = দিকনির্নয়
near = নিকট
nearby = নিকটবর্তী
nearest = সবচেয়ে কাছে
nearly = প্রায়
neat = পরিচ্ছন্ন
neatness = পরিচ্ছন্নতা
nebula = নীহারিকা
nebulous = কুয়াশাচ্ছন্ন
necessarily = প্রয়োজনীয়ভাবে
necessary = প্রয়োজনীয়
necklace = মালা
need = প্রয়োজন
need = প্রয়োজন
need = প্রয়োজন বোধ করা
needed = প্রয়োজনীয়
needed = প্রয়োজন
needle = সূচ
needlessly = বিনা প্রয়োজনে
negation = নঞর্থক
negative = ঋণাত্মক
negatively = ঋণাত্মকভাবে
negligence = অবহেলা
negotiate = আপোষে ঠিক করা
neighboring = নিকটবর্তী
neighbourhood = নিকটবর্তী অঞ্চল
neo = নব্য
nephew = ভাগনে
nerd = একরোখা প্রযুক্তিবিদ
nerve = স্নায়ু
nervous = স্নায়বিক
nest = নীড়
nests = নীড়
net = নেট
network = নেটওয়ার্ক
network = নেটওয়ার্ক
networking = নেটওয়ার্কিং
networks = নেটওয়ার্ক
neurosis = স্নায়ুবৈকল্য
neutral = নিরপেক্ষ
neutrality = নিরপেক্ষতা
neutrino = নিউট্রিনো
neutrons = নিউট্রন
never = কখনো না
never = কখনও না
nevertheless = তাহলেও
new = নতুন
newer = অপেক্ষাকৃত নতুন
newest = নতুনতম
newest = সবচেয়ে নতুন
newly = সদ্যঃ
news = খবর
news = সংবাদ
newspaper = সংবাদপত্র
newspapers = সংবাদপত্র
newsprint = নিউজপ্রিন্ট
next = পরবর্তী
nibble = চিবানো
nice = সুন্দর
nickname = ডাকনাম
nickname = ডাকনাম
nickname = ডাকনাম
niggardly = বদ্ধমুষ্টি
night = রাত্রি
nineteenth = উনবিংশ
ninety = নব্বই
ninth = নবম
nipples = বোটা
nitrogen = নাইট্রোজেন
no = না
noble = মহৎ
nobody = কেউ না
nodes = নোড
noise = কোলাহল
noisily = সশব্দে
noisy = কোলাহলপূর্ণ
nominal = নামেমাত্র
nominate = মনোনয়ন
nomination = মনোনয়ন
non = নয়
nonbusiness = অব্যবসায়িক
nonconformist = অনুগামী নয় এমন ব্যক্তি
none = কোনটিও নয়
nonessential = অপ্রয়োজনীয়
nonmetallic = অধাতব
nonsense = নিরর্থক
nonstop = একটানা
nonviolence = অহিংস
nonviolent = অহিংস
nonworking = অকেজো
noon = মধ্যাহ্ন
noontime = দুপুর
norm = প্রথা
normal = স্বাভাবিক
normalize = সমন্বয়সাধন করা
normalized = সমন্বয়সাধনকৃত
normally = সাধারণভাবে
north = উত্তর
north = উত্তর দিক
northeast = উত্তর পূর্ব
northeast = উত্তর-পূর্ব
northern = উত্তর
northwestern = উত্তর-পশ্চিম
nose = নাক
nostalgia = অতীতাসক্তি
not = না
notable = লক্ষণীয়
notably = উল্লেখযোগ্যভাবে
note = নোট
note = নোট
note = লক্ষ্য করা
notepad = খাতা
notes = নোট
noteworthy = উল্লেখযোগ্য
nothing = কিছুইনা
notice = নোটিস
notice = লক্ষ্য করা
noticeable = লক্ষণীয়
notification = বিজ্ঞপ্তি
notifications = বিজ্ঞপ্তি
notify = ঘোষণা করা
nourish = লালন পালন করা
novel = উপন্যাস
now = এখন
now = এখন
nowadays = আজকাল
nowhere = কোথাও না
nozzle = মুখ
nozzles = মুখ
nuclear = পরমাণবিক
nuclei = নিউক্লিয়াস
nucleus = নিউক্লিয়াস
nudge = হালকাভাবে ঠেলা
nudism = নগ্নত্ব
null = ফাঁকা
nullify = ‌উপদমন করা
number = নম্বর
numbering = ক্রমায়ণ
numbers = সংখ্যা
numerator = লব
numerically = সংখ্যাগতভাবে
numerous = অনেক
nurse = সেবিকা
nut = বাদাম
nutrition = পুষ্টিবিধান
oaf = বোকা লোক
oasis = মরুদ্যান
obedience = বাধ্যতা
obese = মোটা
object = অবজেক্ট
object = বস্তু
objection = আপত্তি
objective = লক্ষ্য
objects = বস্তু
obligation = বাধ্যবাধকতা
oblige = সুবিধা দেওয়া
oblique = বাঁকানো
obscene = অশ্লীল
observable = প্রতীয়মান
observation = পর্যবেক্ষণ
observatory = মানমন্দির
observe = পর্যবেক্ষণ
observer = পর্যবেক্ষক
obsolete = পুরাতন
obstacle = বাধা
obstruct = বাধা দেওয়া
obstruct = বাধা দেওয়া
obtain = সংগ্রহ
obtained = সংগ্রহ
obvious = বোধগম্য
occasion = উপলক্ষ্য
occasionally = কখনও কখনও
occupation = পেশা
occupied = অধিকৃত
occupy = দখল করা
occur = ঘটা
occurrence = সংঘটন
ocean = সাগর
ochre = গিরিমাটি
octane = প্যারাফিনজনিত হাইড্রোকার্বন অকটেন
octopus = অক্টোপাস
odd = বেজোড়
odyssey = দুঃসাহসিক যাত্রা
of = এর
off = বন্ধ
offer = প্রস্তাব
offer = প্রস্তাব দেওয়া
office = অফিস
officer = আধিকারিক
official = সরকারী
official = আধিকারিক
officially = সরকারী ভাবে
offset = অফসেট
offset = অফসেট করা
often = প্রায়শই
oh = ওহ
oil = তেল
oilseeds = তৈলবীজ
old = পুরনো
older = অপেক্ষাকৃত পুরনো
olive = ওলিভ
omit = বাদ দেওয়া
on = চালু
once = একবার
one = এক
one = এক
ongoing = চলমান
onion = পেঁয়াজ
online = অনলাইন
only = একমাত্র
only = কেবল
onward = পরবর্তী
opaque = অস্বচ্ছ
open = মুক্ত
open = খোলা
open = খোলা
open = খোলা
opening = খোলা হচ্ছে
opening = আরম্ভ
operate = পরিচালনা কর
operate = চালনা করা
operated = পরিচালিত
operating = অপারেটিং
operation = অপারেশন
operational = ক্রিয়াকলাপ সংক্রান্ত
operations = ক্রিয়াকর্ম
operator = অপারেটর
operators = পরিচালক
opinion = মতামত
opponent = বিরোধী
opportune = অনুকূল
opportunist = সুবিধাবাদী
opportunities = সম্ভাবনাগুলো
opportunity = সুযোগ
oppose = বিরোধিতা করা
opposing = বিরোধী
opposite = বিপরীত
opposition = বিরোধী
opt = পছন্দ করা
optical = আলোক সম্বন্ধীয়
optical.fFber = অপটিকাল ফাইবার
optimism = আশাবাদ
optimistic = আশাবাদী
optimum = সর্বোৎ‍কৃষ্ট
option = অপশন
optional = ঐচ্ছিক
options = অপশনস
or = অথবা
oral = মৌখিক
orally = মৌখিকভাবে
orbit = কক্ষপথ
orchard = ফলের বাগান
orchards = ফলের বাগান
order = ক্রম
order = ধারা
ordered = নির্দেশকৃত
orderly = গোছানো
ordinary = সাধারণ
ordinary = সাধারণ
ore = আকরিক
organism = প্রাণী
organization = সংস্থা
organize = আয়োজন
organized = সংগঠিত
organized = সংগঠিত
orientation = দিশা
origin = মূল
original = মূল
originally = আসলে
originate = উদ্ভূত হওয়া
ornament = গহনা
ornate = সুসজ্জিত
orphan = অনাথ
orthodox = গোঁড়া
os = অপারেটিং সিস্টেম
oscillation = দোলন
ostentation = জাঁকজমক
other = অন্যান্য
other = অন্যান্য
others = অন্যান্য
otherwise = অন্যথা
otherwise = অন্যথায়
ounce = আউন্স
our = আমাদের
out = বাইরে
out = বাইরে
out = বাইরে
outback = বিচ্ছিন্ন গ্রাম্য এলাকা
outbound = বহির্গামী
outcome = ফলাফল
outer = বাহ্যিক
outface = সামনা সামনি হওয়া
outgoing = বিদায়ী
outlawed = সমাজ থেকে বহিষ্কৃত
outline = রূপরেখা
outline = রূপরেখা বর্ণনা করা
outlook = দৃষ্টিকোণ
outlying = প্রান্তবর্তী
output = আউটপুট
output = ফলাফল
outrage = দৌরাত্ম্য
outside = বাইরে
outskirts = প্রান্ত
outsource = আউটসোর্স
outsource = আউটসোর্সিং করা
outsourced = আউটসোর্সিং-কৃত
outsourcing = আউটসোর্সিং
outward = বহির্মুখে
oven = চুল্লি
over = পার হয়ে যাওয়া
over = শেষ
over = শেষ হয়ে যাওয়া
over = সম্পন্ন
overall = সর্বপরি
overestimate = মাত্রাতিরিক্ত মূল্য বিচার করা
overlap = আংশিকভাবে আবৃত করা
overlap = আংশিকভাবে আবৃত করা
overlay = প্রলেপ
overnight = রাতারাতি
overpopulation = অত্যাধিক জনসংখ্যা
override = অগ্রাহ্য করা
oversee = তদারকি করা
oversize = বেশি বড়
oversupply = অতিরিক্ত সরাবরাহ
overview = অবলোকন
overwrite = উপর দিয়ে লেখা
owl = পেঁচা
own = নিজের
own = মালিক হওয়া
owned = মালিকানাধীন
owner = মালিক
ownership = মালিকানা
oxidation = জারণ
oxide = অক্সাইড
oyster = ঝিনুক
pacifist = শান্তিকামী
pack = প্যাক
package = প্যাকেজ
packages = প্যাকেজ
packet = প্যাকেট
paddle = বৈঠা
padlock = তালা
page = পৃষ্ঠা
pageantry = চমকপ্রদ
pages = পাতাগুলো
paint = রং
paint = রং করা
paintbrush = তুলি
painting = চিত্র
pal = পাল
palace = ইমারত
palazzo = নজরকারা দালানকোঠা
palette = প্যালেট
pallor = ফ্যাকাসে
palm = চেটো
pamphlet = প্যাম্‌ফ্‌লেট
pancreas = অগ্নাশয়
panel = প্যানেল
panic = আতঙ্ক
pant = হাঁপানো
paper = কাগজ
paperback = পেপারব্যাক
parade = প্রদর্শন করান
paradise = স্বর্গোদ্যান
paradox = আপাতবিরোধী সত্য
paragraph = অনুচ্ছেদ
paragraphs = অনুচ্ছেদ
parallel = সমান্তরাল
parallel = সমান্তরাল
parameter = মান
parameters = মানসমূহ
paranoia = প্যারানয়া
parasite = পরজীবী
parcel = পার্সেল
parent = উর্ধ্বস্থ
parent = পেরেন্ট
parks = পার্ক
parliamentary = সংসদীয়
part = অংশ
part = খন্ড
partial = আংশিক
partially = আংশিকভাবে
participate = অংশগ্রহণ
participating = অংশগ্রহণকারী
particle = কণা
particles = কণা
particular = বিশেষ
particularly = বিশেষভাবে
partition = পার্টিশন
partly = আংশিক ভাবে
partner = সঙ্গী
partnership = অংশীদারী
party = দল
pass = পাশ
pass = পাশ করা
passably = চলনসইভাবে
passage = প্রস্থান
passed = পাশ
passenger = যাত্রী
passengers = যাত্রী
passion = গভীর অনুরাগ
passport = পাশপোর্ট
passwords = পাসওয়ার্ড
past = অতীত
past = শেষ
pasta = পাস্তা
paste = পেস্ট
paste = সাঁটা
pastor = পালক
pasture = পশুচারণভূমি
patch = প্যাচ
patch = প্যাচ করা
patched = প্যাচ-কৃত
patches = প্যাচ
patent = পেটেন্ট
paternal = পৈতৃক
paternity = পিতৃত্ব
path = পাথ
paths = পাথ
patience = ধৈর্য্য
patient = রুগী
patron = পৃষ্ঠপোষক
patronage = পৃষ্ঠপোষকতা
pattern = নকশা
patterns = নকশা
pause = আটকে রাখো
pause = বিরতি
paved = শান-বাঁধানো
pay = প্রদান করা
payment = অর্থপ্রদান
pea = মটর
peace = শান্তি
peaceful = শান্তিপূর্ণ
peacefully = শান্তিপূর্ণভাবে
peacock = ময়ূর
peak = চূড়া
peak = চূড়া
peaks = চূড়া
pearl = মুক্তা
pearly = মুক্তাতূল্য
peculiarity = বৈশিষ্ট্যতা
pedagogical = সহজবোধ্য
pedantic = পণ্ডিতিপনা
peer = সমকক্ষ
pen = কলম
penalize = শাস্তি প্রদান করা
penalty = শাস্তি
penchant = ঝোঁক
pencil = কাঠ পেনসিল
pending = অমীমাংসিত
penetration = ভেদ করা
peninsula = উপদ্বীপ
pentagon = পঞ্চভূজ
penthouse = ঢালু আচ্ছাদন
people = জনগণ
pepper = মরিচ
per = প্রতি
perceives = উপলব্ধি করা
percent = শতাংশ
percentage = শতকরা
perennial = চিরজীবী
perfect = নির্ভুল
perfection = নিখুঁত
perfectly = নির্ভুলভাবে
perforated = ছিদ্র যুক্ত
perform = কর্ম সম্পাদন
performance = সম্পাদন
performer = কুশলী
perfume = আতর
perhaps = সম্ভবত
period = পর্যায়কাল
periodic = পর্যাবৃত্ত
periodical = পর্যায়ক্রমিক
periodically = পর্যায়ক্রমে
peripheral = যন্ত্রপাতি
periphery = চৌহদ্দি
perish = ধ্বংস হওয়া
perjury = বিশ্বাসভঙ্গ
permanent = স্থায়ী
permanently = স্থায়ীভাবে
permission = অনুমতি
permit = অনুমতি দেওয়া
permit = অনুমতি দেওয়া
permitted = অনুমোদিত
perpendicular = লম্ব
perpendicularly = উল্লম্বভাবে
persist = টিকে থাকা
persistent = পুনঃপুন ঘটনশীল
person = ব্যক্তি
personal = ব্যক্তিগত
personal.cCmputer = ব্যাক্তিগত কম্পিউটার
personality = ব্যক্তিত্ব
personalize = ব্যক্তিগতকরণ
personally = ব্যক্তিগতভাবে
personnel = সামরিক বাহিনীর সদস্য
perspective = দৃষ্টরূপ
perturbation = বিচলন
peruse = পুঙ্খানুপুঙ্খভাবে পরীক্ষা করা
pervasive = পরিব্যাপক
pessimistic = নিরাশাবাদী
petition = প্রার্থনাপত্র
petrochemical = পেট্রোকেমিক্যাল
petrochemicals = পেট্রোকেমিক্যাল
petroleum = পেট্রোলিয়াম
pharmacist = ঔষধ বিক্রেতা
phase = কলা
phenomena = প্রত্যক্ষ ঘটনা
phenomenal = বিস্ময়কর
phenomenon = প্রত্যক্ষ ঘটনা
philosopher = দার্শনিক
philosophical = দার্শনিক
philosophically = দর্শনশাস্ত্রানুযায়ী
philosophy = দর্শনবিদ্যা
phone = ফোন
phones = ফোন
photo = ছবি
photo = ফটো
photocathode = ফটো-ক্যাথোড
photocopy = ফটোকপি করা
photograph = আলোকচিত্র
photographer = চিত্র গ্রাহক
photographs = ফটোগ্রাফ
photography = আলোকচিত্রবিদ্যা
photos = ফটো
phrase = শব্দসমষ্টি
physical = ভৌত
physical = ভৌতিক
physicist = পদার্থবিজ্ঞানী
physics = পদার্থবিজ্ঞান
pick = তোলা
pick = চয়ন করা
picture = ছবি
picture = ছবি
pictures = ছবি
piece = টুকরা
piece = অংশ
piercing = বিদ্ধ করা
pig = শূকর
pile = স্তুপ
pilgrim = তীর্থযাত্রী
pilgrimage = তীর্থ
pillar = থাম
pilot = বিমানচালক
pilots = বিমানচালক
pinch = চিমটি কাটা
pine = পাইন গাছ
pineapple = আনারস
pink = গোলাপী
pink = গোলাপী
pinnacle = চূড়া
pipe = পাইপ
pirate = জলদস্যু
pistol = পিস্তল
pitch = শব্দের গ্রাম
pitiless = নির্মম
pituitary = পিটুইটারি
pity = দরদ
place = স্থান
place = রাখা
placebo = সৌখিন ঔষধ
placed = স্থাপিত
placement = স্থাপনা
places = স্থান
placing = অবস্থান
plagiarize = অন্যের লেখা চুরি করা
plague = প্লেগ
plain = সাধারন
plan = পরিকল্পনা
plan = পরিকল্পনা করা
planetary = গ্রহবিষয়ক
plans = পরিকল্পনাসমূহ
plant = গাছপালা
plantation = চাষ
plantations = আবাদ
plasmodium = প্লাজমোডিয়াম
plastic = প্লাস্টিক
plateau = মালভূমি
platform = প্ল্যাটফর্ম
play = প্লে
play = খেলা
playable = চালানোর যোগ্য
playback = চালানো
played = চালানো সম্পন্ন
player = খেলোয়াড়
players = প্লেয়ার
playfulness = পরিহাসপ্রিয়তা
playground = খেলার মাঠ
playing = চালানো হচ্ছে
playroom = খেলাঘর
playtime = খেলার সময়
plaza = চত্বর
plea = জবাব
pleasant = আনন্দময়
please = দয়া করে
please = খুশী করা
pleased = আনন্দিত
pleasure = আনন্দ
pleasure = আনন্দ
pleat = পোশাকের ভাঁজ
pledge = অঙ্গীকার
pledge = অঙ্গীকার করা
plenty = প্রাচুর্য
plot = ষড়যন্ত্র করা
plow = উলটানো
ploy = চাল
plunder = লুঠের মাল
ply = নিয়মিতভাবে চলাচল করা
pneumonia = নিউমোনিয়া
pockmarked = বসন্তের দাগ যুক্ত
poem = কবিতা
poet = কবি
poetry = কবিতা
point = বিন্দু
pointer = নির্দেশক
pointing = নির্দেশ করা
pointless = লক্ষ্যহীন
poison = বিষ
polarity = মেরু
polarization = সমবর্তন
pole = মেরু
police = পুলিশ
policeman = পুলিশ
policies = নীতিমালা
policy = নীতিমালা
polish = ঘসা-মাজা করা
polished = মসৃণ
politeness = নম্রতা
political = রাজনৈতিক
politically = রাজনৈতিকভাবে
politics = রাজনীতি
poll = ভোট
pollutant = দূষক
pollutants = দূষক
pollute = নোংরা করা
polluted = দূষিত
polluting = দূষণকারী
pond = পুকুর
pontificate = উপেক্ষা করা
pooling = একত্রীকরণ
poor = দরিদ্র
poorer = গরিব
poorly = পারিপাট্যহীন ভাবে
pop = পপ
popular = জনপ্রিয়
popularity = জনপ্রিয়তা
popularly = জনপ্রিয়ভাবে
populated = জনঅধ্যুষিত
population = জনসংখ্যা
populous = জনবহুল
portable = বহনযোগ্য
portion = অংশ
portrait = প্রতিকৃতি
ports = পোর্ট
pose = অবস্থান গ্রহণ করা
position = অবস্থান
position = অবস্থানে রাখা
position = জায়গা নেওয়া
positioned = অবস্থিত
positive = ধনাত্মক
positively = ধনাত্মকভাবে
posse = সমাজ
possess = ভোগদখল করা
possibilities = সম্ভাবনা
possibility = সম্ভাবনা
possible = সম্ভব
possible = সম্ভাব্য
possibly = সম্ভবত
post = পোষ্ট
post = পোষ্ট করা
postage = ডাকখরচ
postal = ডাক সংক্রান্ত
postcard = পোস্টকার্ড
postcards = পোস্টকার্ড
poster = পোস্টার
posters = পোস্টার
posting = পোষ্টিং
postman = পিওন
postpone = মুলতবি
postscript = পোস্টস্ক্রিপ্ট
postulated = স্বীকৃত
pot = পাত্র
potato = আলু
potatoes = আলু
potential = সম্ভাব্য
potential = সম্ভাবনা
potentially = সম্ভবত
poverty = দারিদ্র্য
powder = চূর্ণ
powdered = চুর্ণীভূত
power = অধিকার
powered = চালিত
powerful = ক্ষমতাশালী
powerless = ক্ষমতাহীন
practice = অভ্যাস
practice = অভ্যাস করা
practitioner = পেশাদার
praise = প্রশংসা
praise = প্রশংসা করা
praising = গুন কীর্তন করা
pray = প্রার্থনা করা
prayer = প্রার্থনা
precariously = অনিশ্চিতভাবে
precaution = সাবধানতা
precious = মূল্যবান
precise = যথাযত
precisely = নির্ভূল
precocious = অকালপক্ক
precocity = অকালপক্কতা
predict = ভবিষ্যদ্বাণী করা
prediction = ভবিষ্যদ্বাণী
predominantly = কর্তৃত্বপূর্ণভাবে
predominate = কর্তৃত্বপূর্ণ হওয়া
prefer = পছন্দ করা
preferably = পছন্দসইভাবে
preference = পছন্দ
preferences = পছন্দ
preferred = পছন্দের
pregnancy = গর্ভাবস্থা
pregnant = গর্ভবতী
preliminary = প্রাথমিক
premier = প্রধান
premier = প্রধান
premises = চত্বর
premises = চত্বর
premium = পুরস্কার
premonition = সতর্কবাণী
prepaid = অগ্রিম
preparation = প্রস্তুতি
prepare = প্রস্তুতি
prepared = প্রস্তুতকৃত
preparer = প্রস্তুতকারী
preparing = প্রস্তুত করা
prepayment = আগাম অর্থপ্রদান
preprocess = প্রি-প্রসেস
preprocess = প্রি-প্রসেস করা
preprocessing = প্রিপ্রসেসিং
prescribe = ব্যবহার করতে উপদেশ দেওয়া
prescription = ব্যবস্থাপত্র
presence = উপস্থিতি
present = বর্তমান
present = উপস্থাপন করা
presentation = উপস্থাপন
presentation = উপহার
presented = উপস্থাপিত
presenting = উপস্থাপন করছে
presently = বর্তমানে
preservative = সংরক্ষক
preserve = বজায় রাখা
preserve = বজায় রাখা
preset = পূর্বনির্ধারিত
president = রাষ্ট্রপতি
president = প্রেসিডেন্ট
press = সংবাদপত্র
press = চাপ দেওয়া
pressure = চাপ
pressure = চাপ দেওয়া
prestige = আত্মসম্মান
prestigious = মর্যাদাপূর্ণ
presumably = অনুমেয় রূপে
presume = ধরে নেওয়া
presumed = মানিত
presumption = অনুমান
pretext = মিথ্যা ওজর
prevail = আয়ত্তে আনতে পারা
prevent = প্রতিরোধ করা
preventative = প্রতিষেধক
prevents = প্রতিরোধ করে
preview = প্রাকদর্শন
previewing = প্রাকদর্শন
previews = প্রাকদর্শন
previous = পূর্ববর্তী
previously = পূর্বে
prey = শিকার
price = দাম
price = মূল্য
pride = গর্ব
priest = পুরোহিত
primaries = প্রাথমিক
primarily = মূলত
primary = প্রাথমিক
prime = প্রধান
prince = রাজপুত্র
princely = রাজকীয়
principal = প্রধান
principal = প্রধান
principle = নীতি
print = ছাপা
print = প্রিন্ট
print = মুদ্রণ
printable = ছাপার যোগ্য
printed = ছাপা
printer = প্রিন্টার
printers = মুদ্রণযন্ত্র
printing = মুদ্রণ
printout = মুদ্রিত পাতা
prints = মুদ্রিত করে
prior = পূর্ব
prior = পূর্বে
priorities = অগ্রাধিকার
priority = অগ্রগণ্য
prison = গারদ
prison = জেলখানা
pristine = অকৃত্রিম
privacy = গোপনীয়তা
private = ব্যক্তিগত
private = ব্যক্তিগত
privately = ব্যক্তিগতভাবে
privileges = বিশেষাধিকার
privy = শৌচাগার
prize = পুরস্কার
probability = সম্ভাব্য
probable = সম্ভাব্য
probably = সম্ভবত
problem = সমস্যা
problems = সমস্যা
procedure = পদ্ধতি
proceed = অগ্রসর হওয়া
process = পদ্ধতি
process = কার্যপ্রণালী
process = ক্রিয়া
processes = প্রসেস
processes = প্রসেস সমূহ
processing = প্রসেসিং
procession = প্রগতি
processor = প্রসেসর
proclaim = ঘোষনা করা
procurement = আহরণ
produce = তৈরি করা
produce = তৈরি করা
producer = প্রযোজক
producers = প্রযোজক
produces = উৎ‍পাদন করে
producing = উৎপাদন করা
product = দ্রব্য
production = উৎ‍পাদন
products = দ্রব্য
professed = ঘোষিত
profession = পেশা
professional = পেশাদারী
professionalism = পেশাদারিত্ব
professions = পেশা
professor = অধ্যাপক
professorship = অধ্যাপনা
profile = প্রোফাইল
profile = বৃত্তান্ত
profit = লাভ
profitable = লাভজনক
profiteering = মুনাফা করা
profits = লাভ করা
profoundly = গভীরভাবে
progess = অগ্রগতি
program = প্রোগ্রাম
program = অনুষ্ঠান
programmer = প্রোগ্রামার
programmers = প্রোগ্রামারবৃন্দ
programming = প্রোগ্রামিং
programs = প্রোগ্রাম
progress = অগ্রগতি
progress = এগিয়ে যাওয়া
progression = প্রগতি
prohibit = নিষিদ্ধ করা
prohibiton = নিষেধাজ্ঞা
project = প্রকল্প
project = প্রক্ষেপ করা
projection = প্রক্ষেপ
projector = প্রক্ষেপক
projects = প্রকল্প
proliferation = দ্রুত পুনরুৎপাদ‍ন
prolong = দীর্ঘায়িত করা
prolonged = দীর্ঘায়িত
prominence = লক্ষনীয়
prominent = বিশিষ্ট
promise = প্রতিজ্ঞা করা
promise = প্রতিজ্ঞা করা
promising = আশাপ্রদ
promote = উৎসাহিত করা
promotion = পদোন্নতি
promptly = তৎপরভাবে
prone = অধোমুখে
pronounce = ঘোষণা করা
pronunciation = উচ্চারণ
proof = প্রমাণ
propaganda = প্রচার
propel = চালিত করা
propensity = ঝোঁক
proper = উপযুক্ত
properly = সঠিকভাবে
properties = বৈশিষ্ট্যাবলী
property = বৈশিষ্ট্য
prophet = নবী
proportion = অনুপাত
proportional = আনুপাতিক
proposal = প্রস্তাব
propose = প্রস্তাব করা
proposed = প্রস্তাবিত
proprietary = বৈশিষ্ট্যাবলী
proprietorship = মালিকানা
propriety = উপযুক্ত আচরন
prospective = সম্ভাব্য
prosperrউন্নতিসাধন
prosperity = সচ্ছলতা
prosperous = সচ্ছল
prostitute = পতিতা
protect = প্রতিরক্ষা করা
protecting = রক্ষা
protection = সুরক্ষা
protein = প্রোটিন
protest = প্রতিবাদ
protest = প্রতিবাদ করা
protest = বাধা দেওয়া
protocol = প্রোটোকল
protons = প্রোটন
protozoan = এককোষীয়
proud = গর্বিত
prove = প্রমাণ
provide = জোগান দেওয়া
provider = সরবরাহকারী
providers = প্রদানকারী
provides = দেয়
province = প্রদেশ
provincial = প্রাদেশিক
provision = সরবরাহ
prowess = দক্ষতা
proximity = নৈকট্য
proxy = প্রক্সি
psycho = বিকৃত 
psychic = মানসিক
puberty = বয়ঃসন্ধি
public = জনগণ
publication = প্রকাশনা
publicly = প্রকাশ্যে
publish = প্রকাশনা
published = প্রকাশিত
publisher = প্রকাশক
publishing = প্রকাশনা
puke = বমি করা
pulchritude = দৈহিক সৌন্দর্য
pull = টানা
pull = টানা
pulp = মন্ড
pulsation = ধুকধুকানি
pulse = ডাল
pulse = ডাল
pummel = উপুর্যুপরি ঘুষি মারা
punch = ছিদ্র করা
punch = ছিদ্র করা
punch = ঘুসি মারা
punctually = সময়ানুবর্তীভাবে
punctuation = বিরাম চিহ্ন
punish = শাস্তি দেওয়া
punishment = শাস্তি
punitive = শাস্তিমূলক
pupil = ছাত্র
puppet = পুতুল
purchase = কেনা
purchase = ক্রয় করা
purchaser = ক্রেতা
pure = নিখাদ
purely = শুদ্ধ ভাবে
purge = বিশোধন
purge = বিশোধন করা
purification = পরিশোধন
purple = রক্তবেগনী
purposeful = উদ্দেশ্যমূলক
purposely = উদ্দেশ্যপূর্ণভাবে
push = ধাক্কা দেওয়া
push = ঠেলা
pussy = যোনি
put = রাখা
put = রাখা
puzzle = হতবুদ্ধি হওয়া
pyramid = পিরামিড
pyre = দাহ
pyrotechnic = আতসবাজি
python = পাইথন
quadruple = চতুর্বিধ
quagmire = বিপজ্জনক পরিস্থিতি
quaint = খাপ-ছাড়া
qualification = যোগ্যতা
qualified = যোগ্য
qualitative = গুণগতভাবে
qualitatively = গুণগতভাবে
quality = গুনমান
quality = মান
quantity = পরিমাণ
quarrel = ঝগড়া করা
quarter = বাসা
queen = রানী
queer = উদ্ভট
quelling = দমনকরা
query = অনুসন্ধান
querying = অনুসন্ধান
quest = খোঁজ
question = প্রশ্ন
question = প্রশ্ন করা
questionnaire = প্রশ্নমালা
queue = সারি
queued = সারিবদ্ধ
quick = দ্রুত
quick = চটপট
quickly = তাড়াতাড়ি
quiescent = নিষ্ক্রিয়
quinine = কুইনাইন
quintessential = নিখুঁত সারাংশ সম্পন্ন
quit = প্রস্থান
quit = প্রস্থান করা
quit = বেরিয়ে এসো
quite = সম্পূর্ণ
quite = সম্পূর্ণভাবে
quota = কোটা
quote = উদ্ধৃত করা
quote = উদ্ধৃত করা
quotes = উদ্ধৃতি
quadrant = চতুর্থাংশ
quadrature = পাদসংস্থান
quantity = সংখ্যা
quarks = কোয়ার্ক
quasar = কোয়েসার
query = অনুসন্ধান করা
queue = সারিবদ্ধ করা
quit = প্রস্থান করা
rabbi = ইহুদি ধর্মযাজক
rabbit = খারগোশ
race = প্রতিযোগিতা
racism = বর্ণবাদ
racist = বর্ণবাদী
radiant = চকচকে
radiate = বিভিন্নদিকে ছড়িয়ে পড়া
radiation = বিকিরণ
radical = মৌলবাদী
radio = আকাশবাণী
radiocarbon = রেডিও কার্বন
radish = মূলা
radius = ব্যাসার্ধ
rag = ছেঁড়া কাপড়
rage = রোষ
rail = রেল
railway = রেল
railways = রেলওয়েজ
rainbow = রামধনু
rainfall = বৃষ্টিপাত
rainstorm = ঝড়বৃষ্টি
rainwater = বৃষ্টির জল
raise = উত্তোলন করা
rampancy = অরাজকতা
random = এলোমেলো
randomization = অনিয়মিতকরণ
randomly = এলোমেলোভাবে
range = সীমা
rank = স্তর
rape = ধর্ষণ করা
rapid = দ্রুত
rapidly = দ্রুতভাবে
rare = বিরল
rarely = কদাচিৎ
rat = ইঁদুর
rate = হার
rather = বরং
rather = বরং
ratification = যাচাই
rating = রেটিং
ratings = রেটিং
ratio = অনুপাত
rationale = মূলনীতি
raucous = কর্কশ
raucously = কর্কশভাবে
raw = কাঁচা
ray = রশ্মি
reach = পৌঁছান
reach = পৌছান
reached = পৌঁছেছে
reacquire = পুনরায় অধিগ্রহন করা
react = প্রতিক্রিয়া ব্যক্ত করা
reaction = প্রতিক্রিয়া
reactivity = সক্রিয়তা
reactor = পারমানবিক চুল্লি
read = পড়া
read = পড়া
read = পাঠ করা
readable = পঠনযোগ্য
reader = পাঠক
readily = প্রস্তুত
reading = পড়া
reading = পড়তে থাকা
readmit = পুনরায় ভর্তি করা
ready = তৈরি
real = প্রকৃত
realistic = বাস্তববাদী
reality = বাস্তবতা
realization = বুঝতে পারা
realize = অনুভব
really = সত্যি
realm = এলাকা
realty = স্থাবর সম্পত্তি
rear = পেছন
rear = প্রতিপালিত করা
reasearch = গবেষণা
reason = কারণ দেখান
reasonable = গ্রহণযোগ্য
reasonably = যুক্তিযুক্ত ভাবে
reasons = কারণ
rebel = বিদ্রোহী
rebel = বিদ্রোহী
rebel = বিদ্রোহ করা
rebellion = বিদ্রোহ
rebuild = পুনর্নির্মাণ
rebuilding = পুনর্নির্মাণ
rebuilds = পুনর্গঠন
rebuke = তীব্র তিরস্কার করা
receive = গ্রহণ করা
received = গৃহীত
receiver = গ্রাহক
receiving = প্রাপ্ত
recent = সাম্প্রতিক
recently = সাম্প্রতিক কালে
recession = মন্দা
recipient = গ্রাহক
recite = আবৃত্তি করা
reckless = বেপরোয়া
reckon = মূল্য বিচার করা
reclaimed = পুনরুদ্ধারকৃত
recognition = পরিচিতি
recognize = চেনা
recognized = চিহ্নিত
recommend = পরামর্শ
recommend = সুপারিশ
recommendation = সুপারিশ
recommendations = সুপারিশ
recommended = সুপারিশকৃত
reconcile = মিলনসাধন করা
reconfigure = পুনরায় কনফিগার
reconnect = পুনঃসংযোগ
reconsider = পুনর্বিবেচনা
reconsider = পুনর্বিবেচনা করা
reconstruct = পুনর্নিমাণ করা
record = রেকর্ড
recorded = রেকর্ডকৃত
recording = রেকর্ডিং
recover = পনরুদ্ধার করা
recoverable = উদ্ধারযোগ্য
recovered = উদ্ধারকৃত
recovery = পুনরুদ্ধার
recreation = উপভোগ
recruit = নিয়োগ করা
recruit = নিয়োগ করা
recruiter = নিয়োগকারী
rectangle = চৌকো
rectangular = আয়তক্ষেত্রাকার
recursive = পুনরাবৃত্ত
red = লাল
red = লাল রঙ
reddish = লালচে
redial = রি-ডায়াল
redirected = দিক পরিবর্তনকৃত
redirection = দিক পরিবর্তন
rediscover = পুনরায় আবিষ্কার
redistribute = পুনর্বিতরণ করা
redo = আবার করা
reduce = হ্রাস করা
reduce = কমান
reduces = হ্রাস করা
reduction = হ্রাসকরণ
reelection = পুনর্নিবাচন
refer = উল্লেখ করা
reference = তথ্যসূত্র
referral = উল্লেখিত
refine = শোধন করা
refined = বিশোধিত
reflect = প্রতিফলন করা
reflection = প্রতিফলন
refocus = পুনরায় ফোকাস করা
reform = পুনর্গঠন
reformer = সংস্কারক
refraction = প্রতিসরণ
refrain = গানের সুর
refresh = ঝালান
refugee = উদ্বাস্তু
refund = ফিরিয়ে দেওয়া
refuse = অস্বীকার
refuse = অস্বীকার করা
refused = অস্বীকৃত
regard = বিবেচনা করা
regard = গণ্য করা
regarded = বিবেচিত
regenerate = পুনরায় উৎ‍পাদন
regime = জ‍মানা
region = অঞ্চল
regional = আঞ্চলিক
register = নিবন্ধন
register = নিবন্ধন করা
registered = রেজিষ্ট্রীকৃত
registering = নিবন্ধন করা
registrant = নিবন্ধনকারী
registrar = রেজিস্ট্রার
registration = নিবন্ধন
registry = রেজিস্ট্রী
regression = প্রত্যাবৃত্তি
regret = অনুতাপ করা
regular = নিয়মিত
regularly = নিয়মিতভাবে
regulation = নিয়মকানুন
regulation = প্রবিধান
regulations = নিয়মকানুন
rehabilitate = পুনর্বাসন করা
rehearsal = পুনরাবৃত্তি
reign = রাজত্ব
reign = রাজত্ব করা
reinstall = পুনরায় ইনস্টল করা
reinstate = পুনর্বহাল
reinvent = পুনরাবিষ্কার করা
reiterate = পুনরাবৃত্তি করা
reject = বাতিল করা
rejected = বাতিলকৃত
rejoice = আনন্দ করা
relate = সম্বন্ধস্থাপন করা
related = সম্পর্কিত
related = সংশ্লিষ্ট
relation = সম্পর্ক
relationship = সম্পর্ক
relationships = সম্পর্ক
relative = তুলনায়
relativity = আপেক্ষিকতাবাদ
relaxation = অবকাশ যাপন
release = মুক্তি দেওয়া
release = মুক্তি দেওয়া
relentlessly = তীব্রভাবে
relevance = প্রাসঙ্গিকতা
relevant = প্রাসঙ্গিক
reliability = নির্ভরযোগ্যতা
reliably = নির্ভরযোগ্যভাবে
relief = ত্রাণ
relieve = উপশম হওয়া
religion = ধর্ম
religious = ধর্মীয়
religious = ধর্মীয়
reload = রিলোড
reload = রিলোড করা
reloaded = রিলোডকৃত
reluctant = অনিচ্ছুক
rely = ভরসা করা
remain = থাকে
remaining = অবশিষ্ট
remake = পুনর্নির্মাণ করা
remark = মন্তব্য
remark = মন্তব্য করা
remarkable = লক্ষণীয়
remarks = মন্তব্য
remarry = পুনরায় বিবাহ কর
remarrying = পুনর্বিবাহ
remedy = প্রতিবিধান
remember = মনে রাখ
remember = মনে রাখা
remnant = অবশিষ্ট
remnants = অবশিষ্ট
remote = প্রত্যন্ত
removable = স্থানান্তরযোগ্য
removal = অপসারণ
remove = সরানো
removed = অপসারিত
remuneration = পারিশ্রমিক
rename = নামান্তর
renamed = নামান্তরকৃত
renaming = নামান্তরকরণ
render = প্রদর্শন
render = ব্যবস্হা করা
rendered = অঙ্কিত
rendering = প্রদর্শন
renown = খ্যাতি
renowned = খ্যাতিমান
rent = ভাড়া
rent = ভাড়া করা
renting = ভাড়া করা
reopen = পুনরায় খোলা
reorganized = পুণর্গঠিত
repair = মেরামত
repatriate = স্বদেশে পুনঃপ্রেরণ করা
repay = পরিশোধ করা
repeat = পুনরাবৃত্তি
repeat = পুনরাবৃত্তি করা
repeated = ক্রমাগত
repeatedly = বারংবার
repent = অনুশোচনা করা
repetition = পুনরাবৃত্তি
replace = বদল
replaced = প্রতিস্থাপিত
replacement = বদলানো
replacements = বদলি
replies = উত্তর
reply = উত্তর
reply = উত্তর দেওয়া
report = প্রতিবেদন
report = বিবরণ
report = রিপোর্ট
reported = প্রতিবেদনকৃত
reporter = প্রতিবেদক
reports = প্রতিবেদন
repositories = ভান্ডার
repository = ভান্ডার
represent = প্রতিনিধিত্ব করা
representation = প্রতিনিধিত্ব
representative = প্রতিনিধি
reproach = নিন্দা
reproduce = জন্ম দেওয়া
reproduction = পুনরায় তৈরী করা
reprove = দোষারোপ করা
republic = প্রজাতন্ত্র
repugnant = বেমানান
reputable = গ্রহণযোগ্য
reputation = খ্যাতি
request = অনুরোধ
request = আবেদন
requested = আবেদনকৃত
requesting = আবেদন করে
requests = আবেদন
require = প্রয়োজন বোধ করা
required = প্রয়োজনীয়
requirement = আবশ্যকতা
requirements = প্রয়োজনীয়
requires = প্রয়োজন হয়
rescue = উদ্ধার
rescue = উদ্ধার করা
research = গবেষণা
researcher = গবেষক
researchers = গবেষকগণ
reservation = সংরক্ষণ
reserve = সংরক্ষণ
reserve = গাম্ভীর্য
reserve = সংরক্ষণ করা
reserved = সংরক্ষিত
reset = রিসেট
reset = পূর্বাবস্থায় ফেরাও
reset = রিসেট করা
reside = বসবাস করা
residency = বাসভবন
resident = বাসিন্দা
residential = বসবাসের জন্য ব্যবহৃত
residents = বাসিন্দা
resign = পদত্যাগ কর
resignation = ইস্তফা
resistance = প্রতিরোধ
resize = পুনরায় সাইজ করা
resize = পুনরায় সাইজ করা
resized = পরিবর্তিত মাপ
resolution = রিসোলিউশন
resolve = সমাধান
resolve = সিদ্ধান্ত গ্রহণ
resort = শরণ নেওয়া
resort = শরণ নেওয়া
resource = পুঁজি
resources = সম্পদ
respect = সম্মান
respect = সম্মান করা
respective = নিজ নিজ
respond = উত্তর দেওয়া
responding = সাড়া দিচ্ছে
response = সাড়া
responsibility = দায়িত্ব
responsible = দায়িত্বশীল
responsive = দ্রুত সাড়াদায়ক
responsiveness = দায়িত্বজ্ঞান
rest = অবশিষ্ট
rest = বিশ্রাম
restart = আবার শুরু
restarted = রিস্টার্টকৃত
restaurant = রেস্টুরেন্ট
restless = অবিরাম
restlessness = অস্থিরতা
restore = পুনরুদ্ধার
restrict = নিয়ন্ত্রণ করা
restricted = নিয়ন্ত্রিত
restricted = সীমাবদ্ধ
restriction = সীমাবদ্ধ-করণ
restrictions = সীমাবদ্ধতা
restricts = সীমাবদ্ধ করে
result = ফল
result = ফলস্বরূপ উদ্ভূত হওয়া
resultant = ফলস্বরূপ
resulting = উদ্ভূত
results = ফলাফল
resume = পুনরায় আরম্ভ
resume = পুনরায় শুরু করা
resumed = পুনরায় আরম্ভকৃত
resurgent = পুনরুজ্জীবিত
retain = বজায় রাখা
retain = ধরে রাখা
retaliation = পাল্টা দূর্ব্যবহার
retention = ধারণ
retired = অবসরপ্রাপ্ত
retract = প্রত্যাহার
retraining = পুনঃপ্রশিক্ষণ
retrieval = আহরন
retrieve = আহরন
retrieve = আহরন করা
retrieving = আহরন করা হচ্ছে
retry = আবার চেষ্টা
retry = পুনঃপ্রচেষ্টা
return = ফেরত
return = ফিরে আসা
returned = ফেরত
reunion = পুনর্মিলন
revaluation = পুনর্মূল্যায়ণ
reveal = প্রকাশ করা
revenue = রাজস্ব
reverent = শ্রদ্ধাশীল
reverse = বিপরীত
reverse = বিপরীত
revert = পূর্বাবস্থায় প্রত্যাবর্তন
review = নিরীক্ষণ
review = পর্যালোচনা
revision = পরিমার্জন
revive = পুনঃপ্রচলন করা
revolution = আবর্তন
revolutionary = বৈপ্লবিক
revolutionize = বিপ্লব ঘটান
revolutions = বিপ্লব
reward = পুরষ্কার
rewrite = পুনরায় লেখা
rewrite = পুনরায় লেখা
rhinoceros = গণ্ডার
rhythm = ছন্দ
ribbon = ফিতা
rice = ধান
rich = ধনী
rich = ধনী
riches = ধনসম্পদ
richly = উদাত্তভাবে
rickety = জিরজিরে
rid = আর-আই-ডি
rider = যাত্রী
ridicule = পরিহাস
ridicule = পরিহাস করা
ridiculous = হাস্যকর
riff = আরআইএফএফ
rift = ফাটল
rigging = নির্বাচনাদিতে কারচুপি
right = ডানদিক
right = ঠিক
right = অধিকার
right = ঠিক
rights = অধিকার
rigid = কঠিন
rile = বিরক্ত করা
rill = খাল
ring = বলয়
riot = দাঙ্গা
riots = দাঙ্গা
rip = রিপ
rip = রিপ করা
ripe = পাকা
ripple = ঢেউ
rise = বৃদ্ধি হওয়া
rise = উঠা
risible = হাস্যকর
rising = উদয়মান
risk = ঝুঁকি
risk = ঝুঁকি নেওয়া
rival = প্রতিদ্বন্দী
rivalry = প্রতিদ্বন্দিতা
riverbank = নদীর তীর
rivers = নদী
road = রাস্তা
roadside = রাস্তার পার্শ্ববর্তী
roaming = ভ্রাম্যমান
robust = শক্তিশালী
rock = রক সঙ্গীত
rocket = রকেট
rocky = পাথুরে
role = ভূমিকা
rollback = পিছনে গড়ান
romantic = রোমান্টিক
roof = ছাদ
room = কামরা
root = মূল
root = রুট
rose = গোলাপ
rotate = ঘোরান
rotation = আবর্তন
rotor = ঘূর্ণক
rotten = পচা
rough = অসমতল
roughly = মোটামুটিভাবে
round = গোল
roundabout = গোলচক্কর
roundtable = গোলটেবিল
roundup = পরিক্রমা
route = পথ
routes = গমনপথ
routine = রুটিন
routinely = ধারাবাহিকভাবে
row = সারি
royal = রাজকীয়
rpm = আরপিএম
rub = কচলানো
rub = ঘসা
rubric = রুবরিচ
rudimentary = প্রাথমিক
ruin = ধ্বংস করা
ruined = ধ্বংসপ্রাপ্ত
rule = নিয়ম
rule = শাসন করা
ruler = শাসক
rules = নিয়ম
ruling = শাষক
run = চল
run = চালানো
run = প্রয়োগ করা
runner = রানার
running = চলন্ত
rupee = রুপি
rural = গ্রামীন
rust = মরচে
rustic = গ্রাম্য
rustle = মর্মরধ্বনি
rusty = মরচে ধরা
sack = বস্তা
sack = বরখাস্ত
sacred = পবিত্র
sad = দুঃখিত
safe = নিরাপদ
safeguard = সুরক্ষিত করা
safely = নিরাপদভাবে
safety = নিরাপত্তা
sail = পাল
sail = হাট
sailor = নাবিক
saint = সন্ত
sake = নিমিত্ত
salary = মাইনে
sale = বিক্রী
sales = বিক্রয়
salinity = লবণতা
salt = নুন
salt = লবণ
salty = নোনতা
salute = অভিবাদন
salvage = পরিতক্ত্য
salvation = উদ্ধার
same = একই
sample = নমুনা
sample = স্যাম্পল করা
sanction = অনুমোদন
sanction = অনুমোদন = করা
sand = বালি
sandalwood = চন্দনকাঠ
sandwich = স্যান্ডউইচ
sandy = বালুময়
sari = শাড়ি
satellite = স্যাটেলাইট
satiety = পরিতৃপ্তি
satisfactorily = সন্তোষজনক ভাবে
satisfactory = সন্তোষজনক
satisfied = সন্তুষ্ট
satisfy = সন্তুষ্ট করা
saturation = সম্পৃক্তি
saute = বেশী আঁচে দ্রুত ভাজা
sauterne = অর্ধমিষ্ট ও অর্ধআদ্র ফরাসী ওয়াইন
savage = নিষ্ঠুর ব্যক্তি
save = সংরক্ষণ করা
saved = সংরক্ষিত
saver = সংরক্ষক
saving = জমা
saviour = পরিত্রাতা
say = বল
say = বলা
scabbard = খাপ
scale = স্কেল
scale = স্কেল করা
scales = স্কেল
scaling = স্কেলিং
scan = স্ক্যান
scan = স্ক্যান করা
scandal = কলঙ্ক
scandalous = কুৎসাপূর্ণ
scanner = স্ক্যানার
scanning = স্ক্যান করা হচ্ছে
scarcity = অভাব
scared = ভীত
scarf = গলা-বন্ধ রুমাল
scatter = ছাড়ানো
scatters = ছড়ানো
scenario = দৃশ্যপট
scene = দৃশ্য
scenes = দৃশ্য
schedule = নির্ধারিত সময়
scheduled = নির্ধারিত
schema = স্কীমা
schematic = নকশা
scheme = পরিকল্পনা
scholar = পন্ডিত
scholarly = বিদ্বজ্জনোচিত
scholarship = বৃত্তি
school = বিদ্যালয়
school = স্কুল
schoolmate = সহপাঠী
sciatica = শ্রোণিস্নায়ুর সুচ ফোটানোর মত বেদনা
science = বিজ্ঞান
science = বিজ্ঞান
sciences = বিজ্ঞান
scientific = বৈজ্ঞানিক
scientifically = বৈজ্ঞানিকভাবে
scientist = বিজ্ঞানী
scope = ব্যাপ্তি
score = স্কোর
scores = স্কোর
scorn = পরিহাস করা
scout = স্কাউট
scratching = চুলকানো
scream = চেঁচানো
screen = পর্দা
screen = স্ক্রীন
screening = বাছাই
script = লিপি
scripts = লিপি
scroll = স্ক্রোল
scuff = পা টেনে হাটা
sculpture = ভাস্কর্য
sea = সমুদ্র
sea = সাগর
seaport = সমুদ্রবন্দর
sear = দগ্ধ করা
search = অনুসন্ধান
search = খোঁজা
search = সন্ধান
searched = অনুসন্ধানকৃত
searches = অনুসন্ধান
searching = খোঁজা হচ্ছে
season = ঋতু
seasonal = ঋতু-ভিত্তিক
seasons = ঋতু
seat = আসন
seawater = সমুদ্রের জল
seclude = সমাজ হতে বিচ্ছিন্ন করা
secluded = নিরালা
second = দ্বিতীয়
second = দ্বিতীয়
secondary = গৌণ
secondly = দ্বিতীয়ত
seconds = সেকেন্ড
secret = গোপন
secret = গোপন
secretaries = সচিব
secretary = সচিব
sectarian = জাতিগত
section = বিভাগ
section = অংশ
sector = সেক্টর
sectors = সেক্টর
secular = ধর্মনিরপেক্ষ
secularism = ধর্মনিরপেক্ষতাবাদ
secure = নিরাপদ
secure = নিরাপদ করা
secured = নিরাপদ
see = দেখা
seed = বীজ
seedbed = বীজতলা
seek = খোঁজ করা
seek = পেতে চেষ্টা করা
seeking = খোঁজা
seem = মনে হওয়া
seen = দৃষ্ট
segment = সেগমেন্ট
seize = বাজেয়াপ্ত
select = নির্বাচিত
select = নির্বাচন
select = বাছাই
selected = নির্বাচিত
selected = বাছাইকৃত
selection = নির্বাচন
selections = নির্বাচন
selective = নির্বাচিত
self = নিজ
selfish = স্বার্থপর
selfishness = স্বার্থপরতা
sell = বিক্রি করা
sell = বিক্রি করা
semantic = শব্দার্থবিদ্যা সম্বন্ধীয়
semen = বীর্য
senate = সেনেট
senator = সেনেট সদস্য
send = পাঠাও
sends = প্রেরণ করে
senior = উর্ধ্বতন
sense = বোধ
sensitive = স্পর্শকাতর
sensitize = সংবেদনশীল করা
sensory = সংজ্ঞাবহ
sent = প্রেরিত
sentence = বাক্য
separate = আলাদা
separate = পৃথক
separate = আলাদা করা
separated = বিচ্ছিন্ন
separately = আলাদাভাবে
separating = বিভক্তকরণ
separation = বিভাজন
sepia = কালচে বাদামী
sequence = ধারা
serendipity = অনাকাঙ্খিত আবিস্কার
serene = প্রশান্ত
serene = শান্ত
serial = সিরিয়াল
series = ধারা
serious = গুরুতর
seriously = গুরুতরভাবে
sermon = ধর্মোপদেশ
serpent = সাপ
servant = চাকর
serve = সরবরাহ করা
server = সার্ভার
servers = সার্ভার
service = চাকরি
service = পরিষেবা
service = সার্ভিস
services = পরিষেবা
services = সার্ভিস
servitude = দাসত্ব
sesame = তিল
session = অধিবেশন
sessions = সেশন
set = মান নির্ধারণ
set = সমষ্টি
set = সেট
setting = বৈশিষ্ট্য
setting = মানসমূহ
settings = মানসমূহ
settle = মীমাংসা করা
settlement = উপনিবেশ
setup = ব্যবস্থাপনা
seven = সাত
seventeen = সতেরো
seventh = ৭ম
several = কতিপয়
severe = মারাত্মক
severely = তীব্রভাবে
severity = তীব্রতা
sex = লিঙ্গ
sex = যৌন কর্ম
sexual = যৌন
sexy = যৌন আবেদনপূর্ণ
sha = এসএইচএ
shade = ছায়া
shaded = প্রচ্ছায়িত
shades = ছায়া
shadow = ছায়া
shah = শাহ
shake = নাড়ান
shake = ঝাঁকানি দেওয়া
shallow = অগভীর
shame = লজ্জা
shame = লজ্জা দেওয়া
shamelessly = নির্লজ্জভাবে
shampoo = শ্যাম্পু
shanty = ঝুপড়ি
shape = আকৃতি
share = শেয়ার
share = ভাগাভাগি করা
share = ভাগাভাগি করা
shared = শেয়ারকৃত
sharing = ভাগাভাগি
sharkskin = হাঙরের চামড়া
sharp = ধারাল
sharpen = স্পষ্ট করা
sharpness = তীক্ষ্ণতা
shawl = শাল
she = সে
shear = কাটছাঁট করা
shear = কাটছাঁট করা
sheath = খাপ
sheep = ভেড়া
sheepskin = ভেড়ার চামড়া
sheet = টুকরা
shell = শেল
shellfire = কামান দাগা
shelter = বাসস্থান
sheriff = শেরিফ
shift = স্থানান্তর
shift = পরিবর্তন করা
shifting = পরিবর্তন
shine = কিরণ দেওয়া
shine = কিরণ দেওয়
shining = উজ্জ্বল
ship = জাহাজ
shipbuilding = জাহাজ নির্মাণ
shipload = জাহাজ-ভর্তি
shipping = স্থানান্তর
shirk = দায়িত্ব এড়ানো
shirt = শার্ট
shit = মল
shivering = কাঁপা
shivery = শিহরিত
shock = ধাক্কা
shock = ধাক্কা দেওয়া
shoe-maker = জুতা নির্মাতা
shoot = গুলি করা
shoot = গুলি করা
shooting = গোলাগুলি
shop = দোকান
shopping = কেনাকাটা
shore = তীর
shoreline = তটরেখা
short = ছোট
short = সংক্ষিপ্ত
shortage = ঘাটতি
shortcut = চটপট
shortcuts = শর্টকাট
shorten = সংক্ষিপ্ত করা
shortened = সংক্ষেপিত
shortly = সল্প সময়ে
shortsighted = অদূরদর্শী
should = উচিত
shout = চিৎকার
shout = চিৎকার করা
shouting = চিৎকার
show = দেখান
show = দেখা
showing = প্রদর্শন করা
shown = প্রদর্শিত
shrewd = বিচক্ষণ
shrewdly = বিচক্ষণতার সঙ্গে
shrewish = খান্ডারি
shrillness = তীব্রতা ও তীক্ষ্ণতা
shrimp = চিংড়ি মাছ
shrine = ধর্মস্থান
shrink = সঙ্কুচিত করা
shrink = সঙ্কুচিত করা
shuffle = এলোমেলোভাবে মেশানো
shut = বন্ধ
shut = বন্ধ করা
shutdown = বন্ধ
shutoff = বন্ধ করা
shy = লাজুক
sick = অসুস্থ
side = পাশ
sign = চিহ্ন
sign = সই করা
signal = সংকেত
signal = সিগন্যাল
signals = সিগন্যাল
signature = স্বাক্ষর
signed = স্বাক্ষরকৃত
signers = স্বাক্ষরকারী
significance = গুরুত্ব
significant = গুরুত্বপূর্ণ
significantly = গুরুত্বপূর্ণভাবে
silence = নীরবতা
silent = নীরব
silently = নিঃশব্দে
silk = রেশম
silken = রেশমি
silky = রেশমী
silver = রুপা
similar = অনুরুপ
similarly = অনুরূপভাবে
similiar = অনুরূপ
simple = সহজ
simple = সরল
simpler = সহজতর
simplified = সরলীকৃত
simply = সহজভাবে
simply = সহজভাবে
simulate = সিমুলেট
simulated = সিমুলেটকৃত
simulation = সিমুলেশন
simultaneously = যুগপৎ ভাবে
sin = পাপ
sin = পাপ করা
since = অতঃপর
sincere = আন্তরিক
sing = গাওয়া
singer = সঙ্গীতশিল্পী
single = একক
single = একা
singles = একক
singular = একবচন
sink = ডোবা
sink = ডুবে যাওয়া
sinner = পাপী
sir = স্যার
sister = বোন
sit = বসা
sit = বসা
site = স্থান
sitting = বসা
situation = পরিস্থিতি
situations = অবস্থা
six = ছয়
sixteen = ষোল
sixth = ষষ্ঠ
sixty = ষাট
size = আকার
size = আকৃতি
size = আয়তন
sizeable = উল্লেখযোগ্য
sizes = মাপ
skeleton = কাঠামো
skeptical = অবিশ্বাসী
skill = দক্ষতা
skilled = দক্ষ
skin = ত্বক
skip = এড়িয়ে যাওয়া
skirmishing = দুই দলের মধ্যে লড়াই
skull = মাথার খুলি
sky = আকাশ
skyscraper = গগনচুম্বী অট্টালিকা
skyscrapers = গগনচুম্বী অট্টালিকা
slack = স্ল্যাক
slap = চড় মারা
slaughter = বধ
slave = দাস
slaying = হত্যা
sleep = ঘুমান
slender = জিরজিরে
slighter = তুচ্ছতর
slip = পিছলে যাওয়া
slipper = চপ্পল
sliver = রূপা
slope = ঢাল
slot = খাঁজ
slow = ধীর
slow = ধীরে করা
slowly = ধীরেধীরে
slum = নোংরা বস্তী
sly = চতুর
small = ক্ষুদ্র
smaller = ক্ষুদ্রতর
smart = কেতাদুরস্ত
smart = চটপটে
smell = গন্ধ
smile = হাসি
smile = হাসা
smiling = হাসিখুসি
smoked = ধূমায়িত
smooth = মসৃণ
smooth = মোলায়েম
smoother = মসৃণতর
smoothly = মসৃণভাবে
smoothness = মসৃণতা
smuggler = চোরাকারবারি
snack = জলখাবার
snake = সাপ
snap = ছবি নেওয়া
snow = তুষার
snowfall = তুষারপাত
snowstorm = তুষার ঝড়
snuff = নস্য
so = সুতরাং
so = সুতরাং
soap = সাবান
sober = সংযমী
sobs = সমব্যথী
soccer = ফুটবল
social = সামাজিক
socialism = সাম্যবাদ
socialist = সমাজতান্ত্রিক
socialist = সমাজবাদী
socially = সামাজিকভাবে
society = সমাজ
socioeconomic = আর্থ-সামাজিক
sociologist = সমাজবিদ
sociology = সমাজতত্ত
socket = সকেট
sodium = সোডিয়াম
soft = নরম
soft = নরম
softness = আর্দ্রতা
software = সফটওয়্যার
soil = মাটি
soil = ময়লা করা
soiled = জমাট
solace = সান্তনা
solar = সৌর
solar.wWnd = সৌরবায়ু
soldier = সৈন্য
sole = একমাত্র
sole = একমাত্র
solemnity = গাম্ভীর্য
solicitor = আইনজ্ঞ
solid = কঠিন
solidarity = ভ্রাতৃত্ব
solitary = একাকী
solo = একক
solstice = অয়ন
soluble = দ্রবণীয়
solution = সমাধান
solutions = সমাধান
solve = সমাধান
some = কিছু
somebody = কোনও একজন
somehow = কোনও ভাবে
someone = কোনও একজন
something = কিছু জিনিষ
sometimes = কখনও কখনও
somewhat = অল্প পরিমাণে
somewhere = কোথাও
son = পুত্র
song = গান
sonic = ধ্বনি সম্বন্ধীয়
soon = শীঘ্রই
soot = ঝুল
sophistication = অবিশুদ্ধতা
sore = ব্যাথা
sorrel = পিঙ্গলবর্ণ
sorrow = দুঃখ
sorry = দুঃখিত
sorry = দুঃখিত
sort = সাজানো
sort = সাজান
sorted = সাজানো
sortie = বেগে নিষ্ক্রমণ
sorting = সাজানো
sound = অটুট
sound = শব্দ
sound = শব্দ করা
soundness = দৃঢ়তা
sounds = শব্দ
soundtrack = সাউন্ড ট্র্যাক
sour = টক
source = উৎ‍স
south = দক্ষিণ
south = দক্ষিণ
southeast = দক্ষিণ পূর্ব
southern = দক্ষিণ
southwest = দক্ষিণপশ্চিম
southwest = দক্ষিণ-পশ্চিম
souvenir = স্মৃতিচিহ্ন
sovereignty = শ্রেষ্ঠত্ব
space = জায়গা
space = ফাঁক
spaces = স্পেস
spaceship = মহাকাশযান
spacious = স্থানবহুল
spaghetti = স্প্যাগেটি
span = প্রসারণ
span = বিস্তার
sparingly = ব্রাত্যভাবে
spasm = খিঁচুনি
spawn = প্রসব করা
spearhead = বল্লমের ডগা
special = বিশেষ
specialist = বিশেষজ্ঞ
specially = বিশেষভাবে
specials = বিশেষ
species = প্রজাতি
specific = সুনির্দিষ্ট
specifically = বিশেষতঃ
specification = সুনির্দিষ্ট বিবরণ
specified = উল্লেখিত
specifies = উল্লেখ করে
specify = উল্লেখ করা
spectacle = চশমা
spectrum = বর্ণালী
speculate = অনুমান করা
speculation = ধারণা
speech = ভাষণ
speed = গতি
speedboat = স্পিডবোট
speedily = দ্রুতভাবে
speedup = গতি বৃদ্ধি
speedy = দ্রুত
spell = বানান
spelling = বানান
spend = খরচ করা
sperm = বীর্য
sphere = গোলক
spherical = গোলকাকার
spice = মসলা
spices = মসলা
spicy = মসলাদার
spider = মাকড়সা
spin = ঘূর্ণন
spin = ঘোরা
spinach = পালং শাক
spine = মেরুদণ্ড
spiral = পেচানো
spiritual = আধ্যাত্মিক
spittle = থুতু
splash = স্প্ল্যাশ
split = বিভক্ত
split = ভাগ
split = বিভক্ত করা
spoken = কথ্য
spokesman = মুখপাত্র
spokeswoman = মহিলা মুখপাত্র
sponsorship = পৃষ্ঠপোষকতা
spoon = চামচ
sporadic = বিচ্ছিন্ন
sport = খেলা
sportsman = খেলোয়াড়
spot = দাগ
spousal = স্বামী বা স্ত্রী সংক্রান্ত
spouse = স্বামী বা স্ত্রী
spread = প্রসারিত
spread = প্রসারিত হওয়া
spreadsheet = স্প্রেডশীট
spreadsheets = স্প্রেডশীট
spree = আনন্দময় ক্রীড়াকৌতুক
spring = বসন্তকাল
spunky = সাহসী
spurn = হয়রান করা
sputnik = স্পুৎনিক
spy = গোয়েন্দা
squad = স্কোয়াড
squander = অপব্যয় করা
square = চৌকো
squash = স্কোয়াশ
squeeze = কচলানো
squirrel = কাঠবিড়ালী
stability = স্থায়ীত্ব
stable = স্থির
stack = গাদা
stack = গাদা করে রাখা
stacking = গাদায় রাখা
stadium = মাঠ
staff = কর্মচারী
stag = পুরুষ হরিণ
stage = দশা
stage = মঞ্চস্থ করা
stagger = টলিতে = টলিতে চলা
stagnant = বদ্ধ
staid = রাশভারী
stair = সিঁড়ি
staircase = সিঁড়ি
stale = বাসী
stalled = স্থগিত
stamp = ডাক টিকিট
stampede = ছত্রভঙ্গ করা
stand = দাঁড়ান
standard = আদর্শ
standard = প্রমাণ
standby = অতিরিক্ত
standing = অবস্থান
staple = জোড়া দেওয়া
stapling = জুড়ে দেওয়া
star = তারকা
star = অভিনয় করা
start = আরম্ভ
start = শুরু
start = শুরু করা
started = আরম্ভকৃত
starting = শুরু করা হচ্ছে
startled = বিস্মিত
starts = শুরু করা
startup = সূচনা
starvation = অনাহার
stat = পরিসংখ্যান
state = অবস্থা
state = রাজ্য
stateless = রাস্ট্র শূন্য
statement = বক্তব্য
states = রাষ্ট্রপুঞ্জ
static = স্থির
statistics = পরিসংখ্যান
statue = মূর্তি
statutory = বিধিসম্মত
staunchly = দৃঢ়ভাবে
stay = থাকা
stay = থাকা
stays = অবস্থান করে
steal = চুরি
steam = বাষ্প
step = ধাপ
stepmother = সৎমা
steps = ধাপ
stereo = স্টেরিও
sterile = বন্ধ্যা
sterility = বন্ধ্য
sterilizer = শুদ্ধিকারক
stern = কঠোর
stethoscope = স্টেথোস্কোপ
sticky = স্টিকি
stiff = অনমনীয়
stiffness = অনমনীয়তা
still = এখনও
stipulate = শর্তাধীন উপস্থাপনা করা
stir = আন্দোলন
stir = আন্দোলন করা
stir = চলা বা চালানো
stitch = সেলাই
stock = ভাণ্ডার
stock = সঞ্চয়
stock = স্টক
stockpiling = মজুদকরণ
stomach = পাকস্থলী
stone = প্রস্তর
stonework = পাথরের কাজ
stop = থামা
stop = থামানো
stopped = স্থগিত
storage = সংরক্ষণাগার
store = সংরক্ষণ
store = সংরক্ষণ করা
stored = সঞ্চিত
stores = জমিয়ে রাখে
storm = ঝড়
story = গল্প
stove = চুল্লি
straight = সরলরৈখিক
strained = নিপীড়িত
strange = আশ্চর্য
stranger = অপরিচিত
strategic = কৌশলগত
strategies = কৌশল
strategy = কৌশল
stratosphere = আন্তর-আকাশ
straw = খড়
stray = খাপ-ছাড়া
stream = স্ট্রীম
streaming = স্ট্রীমিং
streams = স্ট্রীম
street = রাস্তা
strength = শক্তি
strengthen = শক্তিশালী করা
stress = চাপ দেওয়া
stretch = প্রসারিত করা
stretch = প্রসারিত করা
strike = আঘাত করা
string = পংক্তি
string = শব্দসমষ্টি
stringent = কঠোর
strings = পঙ্‌ক্তি
strip = টুকরা
strive = চেষ্টা করা
strive = প্রবল প্রচেষ্টা করা
stroll = ধীরে সুস্থে হেটে বেড়ানো
strong = বলিষ্ঠ
strongly = দৃঢ়ভাবে
structural = গঠনমূলক
structure = কাঠামো
structured = গঠিত
struggle = লড়াই
struggle = সংগ্রাম করা
stub = অসম্পূর্ণ
student = ছাত্র
students = ছাত্রগণ
study = অধ্যয়ন
study = অধ্যয়ন করা
stump = রাজনৈতিক বক্তৃতা
stump = রাজনৈতিক বক্তৃতা দেয়া
stunning = অসাধারন
stupidity = নির্বুদ্ধিতা
stupidly = নির্বোধভাবে
stutter = তোতলান
style = ধরন
styles = ধরন
stylistic = শৈলীগত
sub = উপঃ
subatomic = অতিপারমাণবিক
subcontinent = উপমহাদেশ
subjugation = শাসনাধিকার
sublime = শ্রেষ্ঠ
submarine = ডুবোজাহাজ
submission = দাখিল
submit = উপস্থাপন
submit = পেশ করা
submitting = দাখিল করা হচ্ছে
subordinate = অধীন
subscribe = সম্মতি দেওয়া
subscriber = গ্রাহক
subsequent = পরবর্তী
subsequently = পরবর্তীকালে
subservient = অধীন
subsidiary = সম্পূরক
substance = সারবত্তা
substantial = প্রামান্য
substantiate = প্রমাণ করা
substitute = বিকল্প
substratum = সারবত্তা
subsystem = সাবসিস্টেম
subtitle = সাবটাইটেল
subtitles = সাবটাইটেল
subtle = সুক্ষ্ণ বাছবিচারপূর্ণ
subtraction = বিয়োগ
suburb = শহরতলি
suburban = শহরতলির
suburbs = শহরতলি
succeed = সফল হওয়া
success = সাফল্য
successful = সফল
successfully = সফলভাবে
successive = ধারাবাহিক
successor = উত্তরসূরী
such = যেমন
such = যেমন
suck = চোষণ করা
suck = চোষা
suddenly = হঠাৎ করে
sue = আদালতে মামলা করা
suffer = ভোগা
suffering = ভোগা
sufficient = যথেষ্ট
suffix = সাফিক্স
sugar = চিনি
suggest = প্রস্তাব করা
suggested = প্রস্তাবিত
suggestion = প্রস্তাব
suicide = আত্মহত্যা
suit = মানানসই হওয়া
suit = মানানসই হওয়া
suitability = উপযোগিতা
suitable = উপযুক্ত
suite = স্যুট
sulky = গোমড়া-মুখো
sultan = সুলতান
sum = যোগ
summary = সারসংক্ষেপ
summation = যোগ
summer = গ্রীষ্মকাল
summit = শিখর
summit = চূড়া
summon = সমন জারি করা
sun = সূর্য
sunset = সূর্যাস্ত
sunshine = উজ্জ্বল রোদ
sunspot = সৌরকলঙ্ক
super = সুপার
superfast = অতিদ্রুত
superimpose = একের উপর অন্যকে চাপান
superintendent = তত্ত্বাবধায়ক
superior = উপরস্থ
supernormal = অসাধারণ
supersede = স্থলাভিষিক্ত করা
superstrong = মহাশক্তিশালী
supper = রাতের খাবার
supplementary = সম্পূরক
suppleness = নমনীয়তা
supplied = সরবরাহকৃত
supplier = সরাবরাহকারী
supply = সরবরাহ
supply = সরাবরাহ করা
support = ব্যবহারের সুবিধা
support = সমর্থন
support = সহায়তা
supported = সমর্থিত
supporting = সমর্থন করছে
supports = সমর্থন করে
suppose = অনুমান করা
supposed = অনুমিত
supposedly = তদনুসারে
suppress = দমন করা
suppression = দমন
supreme = সর্বশ্রেষ্ঠ
supreme = পরম
sure = নিশ্চিত
sure = নিশ্চিত
surest = নিশ্চিততম
surface = পৃষ্ঠ
surgery = শল্যবিদ্যা
surname = পদবি
surpass = অতিক্রম
surplus = বাড়তি
surprise = চমক
surprise = চমক দেওয়া
surprised = বিস্মিত
surprising = বিস্ময়কর
surrealistic = অধিবাস্তবিক
surround = পরিবেষ্টন করা
surrounded = পরিবেষ্টিত
surrounding = চারপাশ
survey = পরিদর্শন
survive = বেচে থাকা
survivor = যারা বেচে আছে
susceptible = সংবেদনশীল
suspect = সন্দেহ করা
suspect = সন্দেহ করা
suspected = সন্দেহজনক
suspend = নিলম্বন করা
suspension = স্থগিতাবস্থা
suspensor = নিলম্বক
suspicious = সন্দেহজনক
sustain = সহ্য করা
sustainable = সহনীয়
swallow = গিলে ফেলা
swallow = গিলে খাওয়া
swan = রাজহাঁস
swap = বদলাবদলি করা
sweat = ঘাম
sweet = মিষ্টি
sweetest = মধুরতম
sweetheart = প্রণয়িনী
sweets = মিষ্টি
swell = ফুলে ওঠা
swiftly = দ্রুতভাবে
swimming = সাঁতার কাটা
swing = দোলা
switch = সুইচ
switch = পরিবর্তন
switching = পরিবর্তন
swollen = ফোলা
symbol = চিহ্ন
symbolic = প্রতীকী
symbolical = প্রতীকি
symbols = চিহ্ন
symptom = লক্ষণ
synchronize = যুগপৎ করা
synchronized = যুগপৎ
synchronous = যুগপৎ
synergy = ঐকতান
synonymous = সমার্থক
synopsis = সারাংশ
syntactical = বাক্যের গঠন সম্বন্ধীয়
syntax = বাক্যরীতি
synthesis = সংশ্লেষণ
syringe = পিচকারী
syrup = সিরাপ
system = ব্যবস্থা
systems = সিস্টেম
tab = ট্যাব
tabby = রেশম বিশেষ
table = টেবিল
tableau = স্থির উপস্থাপনা
tablespoon = বড় চামচ
tablet = বড়ি
tabloid = ট্যাবলয়েড
taboo = নিষিদ্ধ
taboo = নিষিদ্ধ করা
tabs = ট্যাব
tacit = নীরব
tactual = স্পর্শগ্রাহ্য
tag = ট্যাগ
tag = ট্যাগ
tagged = ট্যাগযুক্ত
tags = ট্যাগ
tail = লেজ
tailor = দর্জি
taint = দাগ
take = নেওয়া
take = নাও
tale = গল্প
talent = প্রতিভা
talented = প্রতিভাবান
talk = কথা বল
talk = কথা বলা
talks = কথাবার্তা
tame = পোষ মানানো
tandem = সমলয়ে
tank = ট্যাঙ্ক
tap-dance = পায়ের গোড়ালি ও আঙ্গুল দিয়ে টোকা দিয়ে তাল ঠুকে নাচ
tape = টেপ
tapes = ফিতা
tar = টার
target = নিশানা
target = নিশানা করা
targeted = নিশানাকৃত
target = লক্ষ্য স্থির করা
task = কাজ
taste = স্বাদ
tax = কর
taxi = ট্যাক্সি
tea = চা
teach = শিক্ষা প্রদান করা
teacher = শিক্ষক
teachers = শিক্ষকগণ
teaching = শিক্ষাদান
team = দল
team = দল গঠন করা
team = দল গঠন করা
teams = দল
tear = ছেঁড়া
technical = প্রযুক্তিগত
technician = কারিগর
technique = কৌশল
technology = প্রযুক্তি
tedium = ক্লান্তিকরতা
teenager = কিশোর
telegraph = টেলিগ্রাফ
telephone = টেলিফোন
telescope = দূরবীক্ষণ
television = টেলিভিশন
tell = বল
tells = বলে
temperamental = মেজাজি
temperature = তাপমাত্রা
temperatures = তাপমাত্রা
template = ছাঁদ
temple = মন্দির
temples = মন্দির
temporarily = সাময়িকভাবে
temporary = অস্থায়ী
ten = দশ
tenant = ভাড়াটিয়া
tend = প্রবণ হওয়া
tendency = ঝোঁক
tender = দরপত্র
tender = টেন্ডার
tennis = টেনিস
tense = কাল
tensile = নমনীয়
tension = চাপা উত্তেজনা
tentative = সাময়িক
tenth = দশম
tenth = দশম
tenure = মেয়াদ
term = শব্দ
terminal = টার্মিনাল
terminate = শেষ
terminated = সমাপ্তকৃত
termination = সমাপ্ত করা
terminology = পারিভাষিক শব্দ
terminus = টার্মিনাস
terms = শর্তাবলী
terrestrial = পার্থিব
terribly = ভয়ঙ্করভাবে
terrified = আতঙ্কিত
territories = রাজ্য
territory = ভূখন্ড
terror = আতঙ্ক
terrorism = সন্ত্রাসবাদ
terrorist = উগ্রপন্থী
tertiary = তৃতীয়
test = টেস্ট
test = পরীক্ষা
testament = নিয়ম
tester = পরীক্ষক
testing = পরীক্ষাকরণ
tetanus = ধনুষ্টঙ্কার
text = লেখা
textbook = পাঠ্যবই
textbooks = পাঠ্যবই
textile = বস্ত্রবয়ন
textile = বস্ত্র
textiles = বস্ত্রশিল্প
texts = টেক্সট
texture = অঙ্গবিন্যাস
than = চেয়ে
thank = ধন্যবাদ
thanks = ধন্যবাদ
that = সেটা
the = এই
theater = থিয়েটার
theatre = থিয়েটার
theft = চৌর্যবৃত্তি
their = তাদের
theme = থিম
themes = থীম
then = তারপর
theoretical = তত্ত্ব সম্বন্ধীয়
theoretically = তাত্ত্বিকভাবে
theories = তত্ত্ব সমূহ
theorist = তাত্ত্বিক
theory = তত্ত্ব
therapist = চিকিৎসক
there = সেখানে
thereafter = তারপর
therefore = অতএব
thermal = তাপীয়
thermocouple = তাপীয় জোড়
thermodynamics = তাপগতিবিদ্যা
thesaurus = ভাব-অভিধান
these = এই
thesis = গবেষণা নথি
thread = সুতা
they = তারা
thick = পুরু
thicker = অপেক্ষাকৃত পুরু
thief = চোর
thin = পাতলা
thin = পাতলা
thin = ক্ষীণ হওয়া
thing = জিনিস
things = জিনিষ
think = ভাবা
think = ভাবা
thinly = পাতলাভাবে
third = তৃতীয়
thirteen = তের
thirty = ত্রিশ
this = এই
thorn = কাঁটা
those = ঐ
though = যদিও
thought = চিন্তা
thoughtful = সুচিন্তিত
thousand = হাজার
thousands = হাজার
enthrall = অভিভূত করা
thrashing = পরাজয়
thread = থ্রেড
threat = ভীতি প্রদর্শন করা
three = তিন
threshold = প্রবেশদ্বার
thrice = তিনবার
thrifty = গোছানো
throat = গলা
throng = ভিড়
through = মধ্য দিয়ে
thug = গুন্ডা
thumb = বুড়ো আঙুল
thumbnail = থাম্বনেইল
thunder = বাজ
thus = সুতরাং
ticket = টিকিট
tide = ঢেউ
tidiness = পরিষ্কার পরিচ্ছন্ন
tidy = সুবিন্যস্ত
tied = বদ্ধ
tier = সারি
tiered = সারিবদ্ধ
tiff = টিফ
tiger = বাঘ
tile = টালি
tiled = টালি দিয়ে ছাওয়া
till = পর্যন্ত
tiller = হাল
tilt = কাত হওয়া
timber = কাঠ
timber = কাঠ
time = সময়
time = সময়
timed = সময়ভিত্তিক
timely = নিয়মিতভাবে
timer = টাইমার
timers = টাইমার
times = সময়
timid = ভীরু
tiny = খুব ছোট
tip = ইঙ্গিত
tips = ইঙ্গিত
tireless = অক্লান্ত
tissue = স্বচ্ছপ্রায়
title = শিরোনাম
titled = শিরোনামযুক্ত
tits = স্তন
tobacco = তামাক
today = আজ
today = আজ
together = একত্রে
togetherness = একত্রতা
toggle = অদলবদল
toggle = টোগল
token = প্রতীক
tokens = প্রতীক
tolerance = সহনশীলতা
tolerant = সহনশীল
tolerate = সহ্য করা
tolerate = সহ্য করা
toleration = সহনসীমা
tomato = টমেটো
tomorrow = আগামিকাল
tomorrow = আগামী কাল
tone = টোন
toneless = বেসুরো
toner = টোনার
tongue = জিহ্বা
tonight = আজরাত
too = খুব
tool = আনুষঙ্গিক সরঞ্জাম
tools = সরঞ্জাম
top = সর্বোচ্চ
top = মুখ্য
topic = বিষয়বস্তু
torch = আলোকবাতি
tormented = পীড়িত
tornado = টর্নেডো
torrent = টোরেন্ট
torrid = গ্রীষ্মমন্ডলীয়
torture = নির্যাতন
torture = উৎপীড়ন করা
total = মোট
total = সর্বমোট
totally = সম্পূর্ণভাবে
touch = স্পর্শ
touch = স্পর্শ করা
touching = ছুঁয়ে যাওয়া
tough = শক্ত
tour = ভ্রমণ
tourism = পর্যটন
tourist = পর্যটক
toward = দিকে
towards = দিকে
tower = উচ্চ অট্টালিকা
towering = উচ্চ
town = শহর
towns = শহর
toxic = বিষাক্ত
toxic.wWste = বিষাক্ত বর্জ্য
toxicity = বিষাক্ততা
toxin = জৈব বিষ
trace = ছাপ
track = গতিপথ
track = খুঁজে বার করা
trade = বাণিজ্য
trademark = ট্রেডমার্ক
trader = ব্যবসায়ী
traders = ব্যবসায়ী
trading = বাণিজ্য
tradition = ঐতিহ্য
traditional = ঐতিহ্যবাহী
traditionally = প্রথাগতভাবে
traffic = যানচলাচল
trail = দাগ
trailing = অনুসরণ করা
train = ট্রেন
training = প্রশিক্ষণ
trains = ট্রেন
traitor = বিশ্বাসঘাতক
trample = পদদলিত করা
transaction = লেনদেন
transcontinental = আন্তর্মহাদেশীয়
transfer = স্থানান্তর
transfer = স্থানান্তর করা
transfer = স্থানান্তরিত করা
transference = বদলি
transferrable = প্রেরনযোগ্য
transferred = স্থানান্তরিত
transfers = স্থানান্তর
transform = রূপান্তর
transformation = রূপান্তর
transformed = রূপান্তরিত
transit = অন্তর্বর্তী
transition = পরিবর্তন
transitional = অন্তর্বর্তীকালীন
translate = অনুবাদ কর
translated = অনুদিত
translation = অনুবাদ
translations = অনুবাদ
translator = অনুবাদক
translators = অনুবাদকবৃন্দ
translucent = অস্বচ্ছ
transmission = প্রেরণ
transmissions = প্রেরণ
transmit = প্রেরণ
transmitted = প্রেরিত
transmitter = ট্রান্সমিটার
transparencies = ট্রান্সপারেন্সি
transparency = ট্রান্সপারেন্সি
transparent = স্বচ্ছ
transplant = ট্রান্সপ্ল্যান্ট
transponder = ট্রান্সপন্ডার
transport = পরিবহণ
transport = পরিবহণ করা
transportation = পরিবহণ
trash = আবর্জনা
trash = আবর্জনার বাক্সে ফেলা
travel = ভ্রমণ
travel = ভ্রমণ করা
traveling = ভ্রমণ
traverse = অনুপ্রস্থভাবে পার হওয়া
trawl = মাছ ধরার বড় জাল
tray = ট্রে
trays = ট্রে
treacherous = বিশ্বাসঘাতী
treason = বিশ্বাসঘাতকতা
treasure = ধনদৌলত
treasures = ধনদৌলত
treasury = কোষাগার
treat = আচরণ করা
treat = চিকিৎসা করা
treatise = গবেষণাধর্মী গ্রন্থ
treatment = চিকিৎসা
treaty = সন্ধি
treble = তিনগুণ
tree = গাছ
trees = গাছগুলি
tremendous = প্রচন্ড
tremendously = প্রচন্ডভাবে
tremulous = কম্পিত
trend = প্রবণতা
triangle = ত্রিভুজ
triangles = ত্রিভুজ
tribal = উপজাতীয়
tribe = উপজাতি
tribute = শ্রদ্ধাজ্ঞাপন
trickster = প্রতারক
tricky = চতুর
tries = চেষ্টা
trifle = তুচ্ছ
trigger = সূত্রপাত করা
triggers = চালু করা
trio = ত্রয়ী
triple = তিনগুন
triple = তিনগুন করা
triumph = বিজয়
trivial = সামান্য
troop = সৈন্য
trophy = পুরস্কার
tropical = গ্রীষ্মমণ্ডলীয়
trouble = বিপদ
trouble = অশান্তি
trough = নালা
true = সঠিক
truly = সত্যিকারের
trust = আস্থা
trust = বিশ্বাস
trust = বিশ্বাস করা
truth = সত্য
truthful = সৎ
try = চেষ্টা
try = চেষ্টা করা
trying = চেষ্টা করছে
tsunami = সুনামি
tumble = উল্টানো
tumbler = বাটি
tumour = টিউমার
tune = সুর
tune = সুরময় করা
tunnel = সুড়ঙ্গ
turn = বাঁক
turn = বদলান
turning = বাঁক
turpentine = তারপিন
turquoise = বৈদূর্য
turtle = কচ্ছপ
tusk = প্রলম্বিত দাঁত
tutor = গৃহশিক্ষক
tuxedo = টুক্সেডো
tv = টিভি
twaddle = নীরস কথাবার্তা
twelve = বারো
twentieth = বিংশ
twenty = কুড়ি
twice = দুইবার
twilight = প্রদোষকাল
twin = জমজ
twist = প্যাঁচ
twisting = পাকানো
two = দুই
type = টাইপ
type = ধরন
types = ধরন
typhoon = টাইফুন
typical = প্রতিরুপ
typing = টাইপ করা
typing = টাইপ করছে
typographical = টাইপোগ্রাফি সংক্রান্ত
ubiquitous = সর্বত্র বিদ্যমান
ubiquitousness = সর্বত্র বিদ্যমান
uglier = জঘন্যতর
ultimate = চরম
ultraviolet = অতিবেগুনী
umbrella = ছাতা
umpire = আম্পায়ার
unable = অক্ষম
unadulterated = নির্ভেজাল
unalterable = অপরিবর্তনীয়
unaltered = অপরিবর্তিত
unanticipated = অপ্রত্যাশিত
unattainable = পাওয়ার বাইরে
unavailable = পাওয়া যাচ্ছে না
unborn = জন্মায়নি এমন
uncertain = অনিশ্চিত
unchangeable = অপরিবর্তনীয়
unchanged = অপরিবর্তিত
unchanging = অপরিবর্তনীয়
unclassified = অশ্রেণীকৃত
uncle = কাকা
unclear = অস্বচ্ছ
unclothed = নগ্ন
uncombed = না আচড়ানো
uncommon = বিরল
unconfirmed = অসমর্থিত
uncontested = প্রতিদ্বন্দ্বিতাবিহীনভাবে
uncorrected = অসংশোধিত
undeclared = অঘোষিত
undefeated = অপরাজিত
undefined = অনুল্লেখিত
undemocratic = অগণতান্ত্রিক
undeniable = অনস্বীকার্য
undepicted = অচিত্রায়িত
under = অধীনে
under = তলায়
under = নিচে
underage = অপ্রাপ্তবয়স্ক
underfunded = অপ্রতুলভাবে লগ্নীকৃত
undergarment = অন্তর্বাস
undergo = সহ্য করা
underground = পাতাল
underline = নিম্নরেখাঙ্কন
underlying = অন্তর্নিহিত
underneath = তলদেশে
underpin = ভিত্তি নির্মান করা
underprivileged = গরীব
underscore = আন্ডারস্কোর
underscores = আন্ডারস্কোর
understand = বোঝা
understandably = বোঝা যায় এমনভাবে
understanding = বোঝাপড়া
underwater = জলনিমগ্ন
underwear = অন্তর্বাস
undeveloped = অনুন্নত
undo = পূর্বাবস্থায় ফিরে যাওয়া
undoubtedly = নিঃসন্দেহে
unearth = খুড়ে পাওয়া
unendurable = অসহ্য
uneventfully = ঘটনাবিরল ভাবে
unexpected = অপ্রত্যাশিত
unexpectedly = অপ্রত্যাশিতভাবে
unfamiliar = অপরিচিত
unfathomable = অতল
unfeasible = অসম্ভব
unfilled = খালি
unfit = অক্ষম
unfixed = অমিমাংসিত
unforgivable = ক্ষমার অযোগ্য
unfortunate = দুর্ভাগ্যজনক
unfortunately = দুর্ভাগ্যবশত
unfree = মুক্ত নয় এমন
ungratified = অপরিপূর্ণ
unharmed = অক্ষত
unhesitatingly = অসংকোচে
unidentified = অজ্ঞাতপরিচয়
uniform = সমান
uniform = প্রাতিষ্ঠানিক পোষাক
uniformity = সমরূপতা
uninsured = বিমা-বিহীন
uninterrupted = অব্যাহত
union = ইউনিয়ন
unique = অনন্য
unit = একক
unite = একত্র করা
unity = একতা
universal = সার্বজনীন
universe = মহাবিশ্ব
university = বিশ্ববিদ্যালয়
unknown = অজানা
unknown = অজ্ঞাত
unless = যদি না
unlikely = অসম্ভাব্য
unlikely = কম সম্ভাবনা
unlimited = অসীম
unlisted = তালিকভুক্ত নয়
unlock = আনলক
unmarketable = বাজার অযোগ্য
unmask = মুখোশ খুলে দেওয়া
unnamed = নামহীন
unnecessary = অপ্রয়োজনীয়
unperturbed = অবিচলিত
unproblematic = ঝামেলাহীন
unproved = অপ্রমাণিত
unproven = অপ্রমাণিত
unpublished = অপ্রকাশিত
unquestionable = প্রশ্নাতীত
unraveled = স্পষ্ট করা = উদঘাটন করা
unreadable = অপাঠ্য
unrealistic = অবাস্তবমূখী
unrecognized = অচেনা
unrecoverable = পুনরুদ্ধারযোগ্য নয় এমন
unregulated = অনিয়ন্ত্রিত
unrelated = সম্পর্কহীন
unrest = অশান্তি
unsafe = নিরাপত্তাহীন
unsatisfied = অপর্যাপ্ত
unsaturated = অপরিপৃক্ত
unsentimental = অসংবেদনশীল
unsheathe = খাপ থেকে = খোলা
unsigned = স্বাক্ষর বিহীন
unspecified = অনুল্লেখকৃত
unspoken = না বলা
unstable = অস্থায়ী
unsuccessful = অসফল
unsuitable = খাপ-ছাড়া
unsupported = অসমর্থিত
unsure = অনিশ্চিত
untamed = অবাধ্য
until = যতক্ষণ
untouched = অপরিবর্তিত
untrustworthiness = বিশ্বাসঘাতকতা
unusable = অব্যবহারযোগ্য
unused = অব্যবহৃত
unusual = অচিরাচরিত
unwanted = অবাঞ্ছিত
unwilling = অনিচ্ছুক
unwillingness = অনিচ্ছা
up = উচ্চতর অংশ
upcoming = আগমনরত
update = সাম্প্রতিকীকরন
update = আপডেট করা
updated = আপডেটকৃত
updating = আপডেট করা হচ্ছে
upgrade = আপগ্রেড
upgrade = উন্নতকরণ
upgrade = আপগ্রেড করা
upheaval = আলোড়ন
upload = আপলোড
upload = আপলোড করা
uploads = আপলোড
uploaded = আপলোডকৃত
uploading = আপলোড করছে
upper = উচ্চতর
upper = উপরের
upper = উপরের অংশ
upright = সোজা
uproar = হৈচৈ
urban = শহুরে
urge = মিনতি করা
urgent = জরুরী
urge = বাসনা
urine = প্রস্রাব
us = আমাদের
usability = ব্যবহারযোগ্যতা
usable = ব্যবহারযোগ্য
usage = ব্যবহারের রীতি-নীতি
use = ব্যবহার
use = ব্যবহার করা
useable = ব্যবহারযোগ্য
used = ব্যবহৃত
useful = কার্যকর
useless = অর্থহীন
user = ব্যবহারকারী
users = ব্যবহারকারী
ussr = রাশিয়া
usual = প্রথাগত
usually = সাধারণত
uterus = জরায়ু
utilities = ইউটিলিটি
utility = ইউটিলিটি
utility = উপযোগীতা
utilize = সদ্ব্যবহার
utopian = কাল্পনিক
utter = চরম
utter = চূড়ান্ত
uttermost = সর্বাধিক
unreachable = নাগালের বাইরে
unsharp = ভোঁতা
unwanted = অপ্রোয়জনীয়
unauthenticated = পরিচয় প্রমাণ ব্যতীত
uncheck = চেক না করা
unclutter = সুশৃঙ্খল অবস্থা
undo = বাতিল
uniform = সঙ্গতিপূর্ণ
uninstall = আন-ইনস্টল
unsatisfied = অসন্তুষ্ট
unsaved = অসংরক্ষিত
unselect = অবাছাইকরণ
unset = নিষ্ক্রিয়করণ
untitled = শিরোনামহীন
untranslated = অননুদিত
untrusted = অবিশ্বস্ত
user/group = ব্যবহারকারী/গ্রুপ
username = ব্যবহারকারীর নাম
understand = বোঝা
undo = বাতিল করা
undo = পূর্বাবস্থায় ফিরে যাওয়া
uninstall = আন-ইনস্টল করা
unlock = আনলক করা
unmount = আনমাউন্ট করা
urinate = প্রস্রাব করা
utilize = সদ্ব্যবহার করা
vacation = অবসরযাপন
vacation = অবকাশ যাপন
vacationers = অবকাশযাপনকারী
vaccine = টীকা
vagina = স্ত্রী লিঙ্গ
valid = বৈধ
validation = বৈধতা
validity = বৈধতা
valley = উপত্যকা
valleys = উপত্যকা
value = মূল্য
values = মান
van = ভ্যান
vandalism = গুন্ডামি
vapor = জলীয় বাষ্প
variable = চলক
variables = চলক
variants = রূপভেদ
variation = পরিবর্তনশীলতা
variety = বিভিন্ন
various = বিবিধ
vary = পরিবর্তন করা
varying = পরিবর্তনশীল
vascular = সংবহন নালিকা সংক্রান্ত
vase = ফুলদানি
vassal = প্রজা
vast = বিশাল
vastly = বিরাটভাবে
vector = ভেক্টর
vegan = উদ্ভিদভোজী
vegetable = শাকসব্জী
vegetables = শাকসব্জী
vegetarian = শাকাহারী
vehicle = গাড়ি
vehicles = গাড়ি
veil = ঘোমটা
vein = শিরা
velocity = বেগ
vendor = বিক্রেতা
veneer = পাতলা আবরণ
venereal = যৌন
venomous = বিষধর
venture = উদ্যোগ
venue = ঘটনাস্থল
venues = ঘটনাস্থল
verandah = বারান্দা
verb = ক্রিয়াপদ
verbal = মৌখিক
verbatim = আক্ষরিকভাবে
verdict = বিধান
verifiable = প্রতিপাদনযোগ্য
verification = যাচাই
verify = যাচাই করা
verifying = যাচাই করছে
verity = বিবৃতি
vermilion = সিন্দুর
vernacular = মাতৃভাষা
versatile = বহু বিষয়ে পন্ডিত
verse = স্তবক
version = সংস্করণ
versions = সংস্করণ
vertical = উলম্ব
vertical = খাড়া
vertically = উলম্বভাবে
very = খুব
very = খুব
vessel = পাত্র
via = হয়ে
vibrate = কম্পিত হওয়া
vibration = কম্পন
vice = অধর্ম
vicinity = কাছাকাছি
vicious = পাপাচারপূর্ণ = কলুষিত = ভয়ানক
victim = শিকার
victorious = বিজয়ী
victory = জয়লাভ
video = ভিডিও
videocasette = ভিডিও ক্যাসেট
view = দেখা
view = প্রদর্শন
viewer = প্রদর্শক
viewpoint = দৃষ্টিভঙ্গি
views = দৃশ্য
villa = বাসা
village = গ্রাম
villager = গ্রামবাসী
villages = গ্রামগুলি
villain = দুর্বৃত্ত
vindictive = প্রতিহিংসাপরায়ণ
vine = আঙ্গুর গাছ
vineyard = আঙ্গুরের ক্ষেত
vintage = মদ
vintner = শুঁড়ী
violate = অমান্য করা
violate = অমান্য করা
violation = লঙ্ঘন
violence = হিংসা
violent = হিংস্র
violet = বেগুনী
violin = বেহালা
violinist = বেহালা বাদক
virgin = কুমারী
virgin = কুমারী
virginity = কুমারী অবস্থা
virile = পুরুষোচিত
virility = পৌরুষ
virtually = ফলতঃ
virtue = গুণ
virtuous = ধার্মিক
virulence = তীব্রতা
virus = ভাইরাস
visa = ভিসা
visage = মুখ
viscera = ভিশেরা
viscous = চটচটে
vise = ভিসা
visible = দৃশ্যমান
vision = দৃষ্টি
visionary = কাল্পনিক
visit = পরিদর্শন
visit = পরিদর্শন করা
visitation = পরিদর্শন
visited = পরিদর্শিত
visiting = দেখা-সাক্ষাৎ সম্বন্ধীয়
visitor = পরিদর্শক
visitors = পরিদর্শক
visual = দৃষ্টি সংক্রান্ত
visualization = দৃশ্যায়ন
visualizations = দৃশ্যায়ণ
visualize = দৃষ্টিগোচর করানো
visually = দৃশ্যত
vital = অত্যাবশ্যক
vitality = জীবনী শক্তি
vitamin = ভিটামিন
vitriol = ভিট্রিয়ল
vivacious = জীবন্ত
vivacity = প্রাণময়তা
vivid = তীব্র/জীবন্ত
vocabulary = শব্দকোষ
vocal = স্বর-সংক্রান্ত
vocalist = গায়ক
vocation = বৃত্তি
vociferous = কোলাহলপূর্ণ
vodka = ভদকা
vogue = হাল ফ্যাশন
voice = স্বর
voice = ব্যক্ত করা
void = শূন্যস্থান
void = শূন্যতা
void = খালি
volatile = উদ্বায়ী
volcano = আগ্নেয়গিরি
volition = ইচ্ছা
volleyball = ভলিবল
voltage = ভোল্ট একক দ্বারা পরিমিত তড়িৎ প্রবাহ
voluble = বাক্‌পটু
volume = আয়তন
voluminous = বৃহদায়তন
voluntary = স্বেচ্ছাসেবী
volunteer = স্বেচ্ছাকর্মী
voluptuous = ভোগবিলাসী
vomit = বমি করা
voracious = অতিভোজী
vortex = জলের ঘূণি
vote = ভোট
vote = ভোট দেওয়া
voting = ভোট দেয়া
voucher = রসিদ
vow = স্বেচ্চাকৃত অঙ্গীকার
vowel = স্বরবর্ণ
vowel = স্বরবর্ণ
voyage = সমুদ্রযাত্রা
vs = বনাম
vs. = বনাম
vulgar = অশিষ্ট
vulnerable = ভেদ্য
vulture = শকুন
vapor = বাষ্প
vaporous = বাষ্পীয়
various = বিভিন্ন
virgin = ভার্জিন
valid = সঠিক
vapour = বাষ্প
varity = হরেকরকম
vicinity = নৈকট্য
visitor = প্রদর্শক
verify = যাচাই করা
view = দেখা
waffle = বকবক করা
wage = শুরু করা
wager = বাজি
wagon = মালবাহী বগি
waif = বেওয়ারিশ মাল
wail = আর্তনাদ
wail = বিলাপ করা
waist = কোমর
waistcoat = ওয়েস্টকোট
wait = অপেক্ষা করা
wait = অপেক্ষা করা
waiter = খাদ্য পরিবেশক
waiting = অপেক্ষারত
waive = অধিকার পরিত্যাগ করা
waiver = স্বত্বত্যাগ
wake = উঠান
wakeful = জাগ্রৎ
walk = হাঁটা
walk = হাঁটা
wall = দেয়াল
wallet = ওয়ালেট
wallets = ওয়ালেট
wallpaper = ওয়ালপেপার
walrus = সিন্ধুঘোটক
waltz = দুই ব্যক্তির ঘুরে ঘুরে নাচা বা নাচানো
wan = পান্ডুবর্ণ
wane = হ্রাস পাওয়া
want = চাওয়া
want = চাওয়া
war = যুদ্ধ
war = যুদ্ধ
war = লড়াই
warbler = গায়ক
ward = প্রহরা
wardrobe = পোশাক
ware = পণ্য
warfare = যুদ্ধ
warhead = ক্ষেপনাস্ত্রের মুখ
warily = সাবধানে
warlike = সামরিক
warm = উষ্ণ
warmth = উষ্ণতা
warn = সাবধান করা
warn = সতর্ক করে দেয়া
warning = সতর্কবাণী
warning = সতর্কবার্তা
warnings = সাবধানবাণী
warp = মোচড়ানো
warped = বিকৃত
warrant = পরোয়ানা
warship = যুদ্ধজাহাজ
wart = আঁচিল
wartime = যুদ্ধকালীন সময়
was = ছিলো
wasp = 
wash = ধোওয়া
washable = ধোওয়া যায় এমন
washer = ধৌত করার যন্ত্র
waste = বর্জ্য
waste = বর্জ্য
watch = নিরীক্ষন করা
watch = ঘড়ি
watch = পর্যবেক্ষণ করা
watchdog = প্রহরী
watcher = পর্যবেক্ষকপিপীলিকা
watchful = সতর্ক
water = জল
waterfall = জলপ্রপাত
watermelon = তরমুজ
waterproof = জলাভেদ্য
watt = বিদ্যুৎশক্তির একক বা মান
wave = তরঙ্গ
wavelength = তরঙ্গদৈর্ঘ্য
waver = তরঙ্গায়িত করা
waves = তরঙ্গ
wax = মোম
wax = বৃদ্ধি পাওয়া
way = পথ
ways = উপায়
we = আমরা
weak = দুর্বল
weaken = দুর্বল করা
weakness = দুর্বলতা
wealth = সম্পদ
wealthy = ধনী
wean = মাই ছাড়ানো
weapon = অস্ত্র
wear = পরিধান
wear = পরিধান করা
weariness = ক্লান্তি
wearisome = শ্রান্তিকর
weary = অবসন্ন
weasel = নেউল
weather = আবহাওয়া
weave = বোনা
weaving = বুনন শিল্প
web = ওয়েব
web = ওয়েব
wed = বিয়ে করা
wedding = বিবাহ
wedge = গোঁজ
wedlock = বিবাহ বন্ধন
wee = পুচকে
weed = আগাছা
week = সপ্তাহ
weekday = সাপ্তাহিক কাজের দিন
weekend = সাপ্তাহিক ছুটির দিন
weekly = সাপ্তাহিক
weep = কাঁদা
weevil = শক্ত খোলা যুক্ত ছোট গুবরে পোকা বিশেষ
weigh = ওজন করা
weight = ওজন
weight = ওজন
weighted = ভারযুক্ত
weightlessness = ওজনহীনতা
weighty = ভারী
weird = অদ্ভুত
welcome = স্বাগত
welcome = স্বাগতম
welcome = স্বাগত জানান
welcoming = স্বাগত জানানো
well = কুয়া
well = ভাল
well = বেশ
west = পশ্চিম
west = পশ্চিমদিক
western = পশ্চিমী
westward = পশ্চিমাভিমুখে
wet = আর্দ্র
wetness = আর্দ্রতা
whale = তিমি
what = কি
wheat = গম
wheat = গম
wheel = চাকা
when = যখন
where = কোথায়
whether = যা
which = কোন
whiff = বাতাসের ঝাপটা
while = যতক্ষণ
while = যখন
whilst = যখন
whim = ঝোঁক
whimper = প্যান প্যান করা
whimsical = খামখেয়ালী
whine = ঘ্যানঘ্যান
whinny = হ্রেষাধ্বনি
whip = চাবুক দিয়ে আঘাত করা
whirlpool = ঘূর্ণি
whiskey = হুইস্কি
whisky = হুইস্কি
whisper = ফিসফিসানি
whisper = ফিসফিস করা
whispering = ফিসফিসানি
whistle = বাঁশি
whit = ফোঁটা
white = সাদা
whitewash = চুনকাম
who = কে
who = কে বা কারা
whole = গোটা
whom = যাকে
whore = পতিতা
whose = কার
whosoever = যেকেহ
why = কেন
wick = পলতে
wicker = কঞ্চি
wicket = উইকেট
wide = প্রশস্ত
widely = বিস্তীর্ণভাবে
widening = চওড়া করা
widespread = বহুবিস্তৃত
widget = উইজেট
widgets = উইজেট
widow = বিধবা
width = প্রস্থ
widths = প্রস্থ
wield = পরিচালনা করা
wife = স্ত্রী
wig = পরচুলা
wild = বন্য
wild = বুনো
wilderness = জনহীন
wildly = বন্যভাবে
wildness = বুনো অঞ্চল
will = অভিলাষ
william = উইলিয়াম
willing = ইচ্ছুক
willingness = আকাঙ্খা
wilt = ধূর্ত
wily = ধূর্ত
win = জয়
win = জয় করা
wind = বায়ু
windmill = বায়ুচালিত কল
window = জানালা
windows = উইন্ডোজ
winds = বায়ু
windy = ঝড়ো
wine = মদ
wing = ডানা
wink = চোখ দিয়ে ইশারা করা
winner = বিজয়ী
winning = বিজয়ী
winnow = তুষ ঝাড়া
winsome = চিত্তাকর্ষক
winter = শীতকাল
winters = শীতকাল
wintry = ঝড়ো
wipe = মোছা
wire = তার
wireless = বেতার
wiring = ওয়ারিং
wiry = তারনির্মিত
wisdom = জ্ঞান
wish = ইচ্ছা
wish = ইচ্ছা করা
wish = ইচ্ছা
wishes = ইচ্ছা
wistful = সতৃষ্ণ
wistfully = সতৃষ্ণভাবে
with = সঙ্গে
wither = বিনষ্ট হওয়া
withhold = পেছনে টেনে রাখা
within = মধ্যে
without = ব্যতীত
withstand = বাধা দেওয়া
witness = সাক্ষী
wittingly = জেনেশুনে
witty = পরিহাসপ্রিয়
wizard = উইজার্ড
wizards = উইজার্ড
woe = শোক
woebegone = বিষাদমলিন
wolf = শেয়াল
womb = গর্ভ
women = মহিলা
wonder = বিস্ময়
wonder = বিস্ময়
wonderfully = চমৎ‍কারভাবে
wonderland = বিস্ময়কর দেশ
wont = অভ্যস্ত
woo = ভালবাসা অর্জনের চেষ্টা করা
wood = কাঠ
wooden = কাঠের তৈরি
woodshed = কাঠের ছাদ
woodwork = কাঠের কাজ
wool = পশম
word = শব্দ
wording = বাক্যে কথন
word = শব্দ
wordy = শব্দবহুল মৌখিক
work = কাজ
work = কাজ করা
worker = কর্মী
workers = কর্মীগণ
working = কর্মরত
workload = কর্মভার
workout = কার্যক্রম
works = কার্যাবলী
workshop = কর্মশালা
workshops = কর্মশালা
workstation = ওয়ার্ক-ষ্টেশন
workstations = ওয়ার্ক-ষ্টেশন
world = বিশ্ব
world = পৃথিবী
worldwide = বিশ্বজনীন
worldwide = বিশ্বব্যাপী
worn = শীর্ণ
worry = চিন্তা
worry = উদ্ধিগ্ন হওয়া
worse = আরও খারাপ
worse = আরও খারাপ
worship = পূজা
worship = পূজা করা
worshipper = পূজারী
worst = জঘন্য
worst = সবচেয়ে খারাপ
worsted = পশমী সূতা
worth = মূল্যবান
worth = মূল্য
worthier = যোগ্যতর
worthy = যোগ্য
would = হবু
wound = ক্ষত
wounded = আহত
wrangling = উচ্চস্বরে কলহবিবাদ করে এমন
wrap = যতটুকু সম্ভব গুটিয়ে ফেলা
wrap = গুটিয়ে ফেলা
wrapped = মোড়ানো
wrapper = মোড়ক
wrath = গভীর ক্রোধ
wrathful = ক্রুদ্ধ
wreck = বিণাশ
wreck = ধ্বংস করা
wrench = প্রচন্ড মোচড়
wrest = জোর মোচড় দিয়া টানা বা ভাঙ্গা
wrestle = কুস্তি করা
wretch = হতভাগ্য লোক
wretched = চরম দুর্দশাগ্রস্ত
wretchedness = হীনাবস্থা
wring = মোচড়ানো
wrinkle = কোঁচকানো চামড়া
wrist = কব্জি
writ = লিখিত আদেশ
write = লেখা
write = লেখা
writer = লেখক
writers = লেখক
writing = লিখন
writing = লিখছে
written = লিখিত
wrong = ভূল
wrong = ভুল
wrongdoing = অনিয়ম
wrongly = ভুলভাবে
wry = পাকানো
water = পানি
well-known = সুপরিচিত
what = কি
wonderful = চমৎকার
woods = জঙ্গল
x-ray = এক্স রে
xenon = নিষ্ক্রিয় গ্যাসীয় মৌল জেনন
xenophobia = বিদেশাতঙ্ক
xerox = মুদ্রণ পদ্ধতিবিশেষ
xmas = ক্রিসমাস
xylo = কাষ্ঠ
xylographer = কাঠের উপর খোদাইকার্য
xylophone = জাইলোফোন
xylene = এসিড
yak = চমরী গাই
yam = মিঠে আলু
yank = হ্যাঁচকা টান
yankee = মার্কিন যুক্তরাষ্ট্রের বাসিন্দা
yard = এক গজ
yarn = বুনা সুতা
yashmak = মুখচ্ছদ
yawn = হাই তোলা
yeah = হ্যাঁ
year = বছর
yearly = বার্ষিক
yearn = আকুলিবিকুলি
yeast = গাজলাবিশেষ
yell = চিৎকার
yellow = হলুদ
yellowish = পীতাভ
yelp = কুকুরের মত ডাকা
yen = জাপানী মুদ্রা
yes = হাঁ
yester = গত
yesterday = গতকাল
yet = এখনও
yield = উৎপাদন
yoga = যোগব্যায়াম
yogurt = দই
yoke = জোয়াল
yokel = গেঁয়ো ভূত
yolk = ডিমের কুসুম
yore = প্রাচীন কাল
you = আপনি, তুমি
young = যুবক
younger = ছোট
youngest = সর্বকনিষ্ঠ
youngster = বালক
your = আপনার, তোমার
yours = তোমার, আপনার
yourself = স্বয়ং
youth = যৌবনকাল
zany = ভাড়
zap = জ্যাপ
zeal = আগ্রহ
zealot = অতি গোড়া লোক
zealous = অত্যন্ত আগ্রহশীল
zebra = জেবরা
zenith = সুবিন্দু
zero = শূন্য
zest = প্রাণবন্ততা
zestfully = তীব্রতা
zinc = দস্তা
zip = বাতাসের মধ্য দিয়ে গুলি ছুটার শব্দের মত শব্দ
zirconium = জির্কোনিয়াম
zodiac = রাশিচক্র
zone = স্থান
zoo = চিড়িয়াখানা
zoom = ছোট বা বড় করা
zoom = বড় করে
i = আমি
